[Longman - gimnazjum]

[Unit 1 Człowiek]
address = adres
age = wiek
date of birth|place of birth = data / miejsce urodzenia
divorced = rozwiedziony
first name = imię
gentleman = dżentelmen, pan
lady = dama, pani
job = zawód
male = płci męskiej
female = płci żeńskie
man|men = mężczyzna, mężczyźni
married = żonaty, zamężna
Miss|Ms = panna
Mrs = pani
MR = pan
marital status = stan cywilny
nationality = narodowość
person = człowiek
people = ludzie
sex = płeć
single = stanu wolnego
Sir = Pan
Madam = Pani
surname = nazwisko
woman = kobieta
women = kobiety
widow = wdowa
widower = wdowiec
ear = ucho
eye = oko
face = twarz
forehead = czoło
hair = włosy
lips = wargi
mouth = usta
nose = nos
tooth = ząb
teeth = zęby
cheek = policzek
chin = broda, podbródek
eyebrow = brew
eyelash = rzęsa
tongue = język
arm = ręka do ramienia
back = plecy
body = ciało
finger = palec u ręki
foot = stopa
feet = stopy
hand = dłoń
head = głowa
leg = noga
neck = szyja
shoulder = ramię
skin = skóra
toe = palec u nogi
elbow = łokieć
knee = kolano
thumb = kciuk
beautiful = piękny
good-looking = atrakcyjny
handsome = przystojny
pretty = ładny
ugly = brzydki
unattractive = nieatrakcyjny
medium height = średniego wzrostu
short = niski
tall = wysoki
fat = gruby
slim = szczupły
thin = chudy
well-built = dobrze zbudowany
sweater = sweter
tie = krawat
tights = rajstopy
top = bluzka, koszulka
tracksuit = dres
trousers = spodnie
T-shirt = koszulka
anorak = kurtka z kapturem, przeciwdeszczowa
nightdress = koszula nocna
sweatshirt = bluza
to be in one's early/late 20|to be in one's mid/late 20 = mieć około 20 / 25 / 30
underwear = bielizna
elderly = w podeszłym wieku
middle-aged = w średnim wieku
old = stary
teenager = nastolatek, nastolatka
young = młody
beard = broda
dark complexion|fair complexion = ciemna / jasna karnacja
moustache = wąsy
pale = blady
round = okrągły
square = kwadratowy
freckles = piegi
pimples = pryszcze
scar = blizna
tanned = opalona
wrinkles = zmarszczki
bald = łysy
blond/dark/brown/red/ grey hair|fair/dark/brown/red/ grey hair|blond/fair/dark/red/ grey hair|blond/fair/brown/red/ grey hair|blond/fair/dark/brown/red hair|blond/fair/dark/brown/grey hair = blond / jasne / ciemne / brązowe / rude / siwe włosy
sleeve = rękaw
zip = zamek błyskawiczny
curly = kręcone
long/medium length|short/medium length = długie / krótkie / średniej długości
straight = proste
wavy = falujące
bag = torba
belt = pasek
boots = buty długie
bracelet = bransoletka
cap = czapka
earrings = kolczyki
glasses = okulary
gloves = rękawiczki
hat = czapka, kapelusz
necklace = naszyjnik
ring = pierścionek
sandals = sandały
scarf = szalik
shoes = buty
trainers = obuwie sportowe
umbrella = parasolka
jewellery = biżuteria
slippers = kapcie
button = guzik
pocket = kieszeń
have a fringe/a pony tail|have a plaits/a pony tail = mieć grzywkę / warkocze / kucyk
spiky = sterczące
casual = nieformalny, codzienny
comfortable = wygodny
elegant|formal = elegancki
fashionable = modny
old-fashioned = niemodny
loose = luźny
tight = obcisły
blouse = bluzka
coat = płaszcz
dress = sukienka
jacket = kurtka, marynarka
jeans = dżinsy
pyjamas = piżama
raincoat = płaszcz przeciwdeszczowy
shirt = koszula
shorts = krótkie spodenki
skirt = spódnica
socks = skarpetki
suit = garnitur
checked = w kratkę
plain = gładki
spotted = w kropki
stripes|striped = paski, w paski
cotton = bawełna
leather = skóra
wool|woollen = wełna,wełniany
get dressed = ubrać się
look good = dobrze wyglądać
put sth on = nakładać na siebie
take sth off = zdejmować
try sth on = przymierzać
wear sth = nosić
fit = pasować, o rozmiarze
it doesn't go with = to nie pasuje do
match = pasować do czegoś
suit = pasować do osoby, jej stylu
boring = nudny
clever = bystry
fair = sprawiedliwy
funny = zabawny
helpful = pomocny
impolite = nieuprzejmy
intelligent = inteligentny
Iazy = leniwy
nice = miły
quiet = cichy
rude = niegrzeczny
shy = nieśmiały
stupid = głupi
unfriendly = nieprzyjazny
ambitious = ambitny
brave = odważny
calm = spokojny
character|personality = osobowość
dishonest = nieuczciwy
hard-working = pracowity
impatient = niecierpliwy
intolerant = nietolerancyjny
irritating = irytujący
lively = pełen życia
loyal = lojalny
modest = skromny
stubborn = uparty
talkative = rozmowny
unpleasant = nieprzyjemny
bored with = znudzony
depressed = przygnębiony
disappointed = rozczarowany
excited = podekscytowany
frightened = przestraszony
happy = szczęśliwy
lonely = samotny
sad = smutny
surprised = zdziwiony
tired = zmęczony
worried = zmartwiony
amused = rozbawiony
exhausted = wyczerpany
accept = akceptować
can't stand sth = nie móc czegoś znieść
dislike = nie lubić
enjoy oneself = bawić się
hate = nienawidzić
like = lubić
love = kochać, uwielbiać
be afraid of = bać się kogoś, czegoś
be angry with = być złym na kogoś
fall in love with = zakochać się w kimś
have a good time = dobrze się bawić
be fond of sb|be fond of sth = lubić kogoś / coś
be in a good mood|be in a bad mood = być w dobrym / złym nastroju
be keen on sth = być czymś bardzo zainteresowanym
change one's mind = zmienić zdanie
have a sense of humour = mieć poczucie humoru
make an impression = zrobić wrażenie

[Unit 2 Dom]
be close to nature = być blisko natury
block of flats = blok mieszkalny
farmhouse = wiejski dom
holiday home = domek letniskowy
cottage = domek, chata
mansion = luksusowa rezydencja
modern apartment block = nowoczesny blok mieszkalny
palace = pałac
skyscraper = drapacz chmur
by the lake = nad jeziorem
by the river = nad rzeką
by the sea = nad morzem
in the city = w mieście
in the city centre = w centrum miasta
in the country = na wsi
in the mountains = w górach
in the main = street na głównej ulicy
town = miasto (małe)
city = miasto (duże)
village = wieś, wioska
in a noisy district = w hałaśliwej dzielnicy
in the capital city = w stolicy
in the suburbs = na przedmieściach
traffic jams = korki uliczne
art gallery = galeria sztuki
bus stop = przystanek autobusowy
busy streets = zatłoczone ulice
cafe = kawiarnia
car park = parking
church = kościół
clean air = czyste powietrze
club = klub
cinema = kino
disco = dyskoteka
factory = fabryka
hospital = szpital
library = biblioteka
museum = muzeum
public transport = publiczne środki transportu
restaurant = restauracja
shop = sklep
shopping centre = centrum handlowe
sports centre = kompleks sportowy
supermarket = supermarket
theatre = teatr
balcony = balkon
bathroom = łazienka
bedroom = sypialnia
dining room = jadalnia
downstairs = na dole domu
floor = podłoga, piętro
garage = garaż
garden = ogród
ground floor = parter
hall = przedpokój
kitchen = kuchnia
lift = winda
living room|sitting room = salon
roof = dach
room = pokój
stairs = schody
swimming pool = basen
toilet = toaleta, ubikacja
upstairs = na górze domu
wall = ściana, mur
attic = strych, poddasze
basement = piwnica
ceiling = sufit
chimney = komin
drive|driveway = podjazd
fence = ogrodzenie, płot
intercom = domofon
lawn = trawnik
study = gabinet, pokój do pracy
terrace = taras
carpet = dywan
chair = krzesło
clock = zegar
decorations = dekoracje, ozdoby
door = drzwi
furniture = meble
painting = obraz, rysunek
picture = obrazek, zdjęcie
poster = plakat
shelf = półka
shelves = półki
window = okno
central heating = centralne ogrzewanie
fitted carpet = wykładzina dywanowa
wallpaper = tapeta
windowsill = parapet
armchair = fotel
coffee table = niski stolik
DVD player = odtwarzacz DVD
fireplace = kominek
plant = roślina
sofa = kanapa
TV set = telewizor
video = wideo
cushion = poduszka na fotelu, kanapie
cooker = kuchenka
cup = filiżanka
dishwasher = zmywarka do naczyń
fridge = lodówka
mug = kubek
plate = talerz
table = stół
teapot = dzbanek do herbaty
cupboard = szafka, kredens
microwave oven = kuchenka mikrofalowa
oven = piekarnik
sink = zlew
wastebin|bin = kubeł na śmieci
alarm clock = budzik
bed = łóżko
blanket = koc
bookshelf = półka na książki
CD player = odtwarzacz CD
desk = biurko
lamp = lampa
pillow = poduszka do spania
rug = chodnik, dywanik
wardrobe = szafa na ubrania
bedside table = stolik nocny
bedspread = narzuta, kapa
bookcase = biblioteczka
chest of drawers = komoda
curtains = zasłony, firanki
drawer = szuflada
bath = wanna
jacuzzi = jacuzzi
mirror = lustro
shower = prysznic
soap = mydło
toothbrush = szczoteczka do zębów
towel = ręcznik
washbasin = umywalka
washing machine = pralka
boring = nudny
cheap = tani
clean = czysty
colourful = kolorowy
comfortable = wygodny
dark = ciemny
dirty = brudny
elegant = elegancki
empty = pusty
expensive = drogi
huge = olbrzymi, wielki
light = jasny
modern = nowoczesny
old-fashioned = staromodny, staroświecki
original = oryginalny
pleasant = przyjemny
sunny = słoneczny
tidy = schludny, posprzątany
warm = ciepły
wooden = drewniany
cosy = przytulny
leather = skórzany
luxurious = luksusowy
marble = marmurowy
messy = zaniedbany, zabałaganiony
nicely decorated = ładnie urządzony
spacious = przestronny
tiny = maleńki
well-equipped = dobrze wyposażony
dangerous = niebezpieczny
peaceful = spokojny
quiet = cichy
safe = bezpieczny
crowded = zatłoczony
lively = tętniący życiem
noisy = hałaśliwy
polluted = zanieczyszczony
above = ponad
at the back of = z tyłu
at the front of = na przodzie
behind = za
between = pomiędzy
close to = blisko
far from = daleko od
in = w
in front of = z przodu, przed czymś
inside = wewnątrz, w środku
in the centre = w centrum, pośrodku
in the corner = w rogu
in the middle = na środku, pośrodku
near = blisko, niedaleko
next to = przy
on = na
on the right|on the left = po prawej / lewej stronie
opposite = naprzeciwko
outside = na zewnątrz
over = nad
under = pod
decorate a room = urządzić pokój
paint the walls pink = pomalować ściany na różowo
estate agent = agent nieruchomości
interior decorator = dekorator wnętrz
make oneself at home = rozgościć się
move in/to|move out/to = wprowadzać / wyprowadzać się / przeprowadzać się do
pay the rent = płacić czynsz
rent a flat = wynajmować mieszkanie
share a room with sb = dzielić z kimś pokój

[Unit 3 Szkoła]
kindergarten|nursery = przedszkole
middle school|junior high school = gimnazjum
primary school|elementary school = szkoła podstawowa
private school|public school = szkoła prywatna
secondary school|high school = szkoła średnia
university = uniwersytet
boarding school = szkoła z internatem
distance learning = uczenie się na odległość
home schooling = nauczanie w domu
single-sex school = szkoła tylko dla chłopców / dziewcząt
state school|public school = szkoła państwowa
Art = plastyka
club = kółko zainteresowań
English = język angielski
foreign languages = języki obce
Geography = geografia
History = historia
IT|Information Technology = informatyka
Mathematics|Maths = matematyka
Music = muzyka
PE|Physical Education = wychowanie fizyczne
RE|Religious Education = religia
Science (Biology,Chemistry,Physics) = nauki ścisłe (biologia, chemia, fizyka)
subject = przedmiot szkolny
canteen = stołówka
classroom = klasa
computer room = pracownia komputerowa
corridor = korytarz
gym|gymnasium = sala gimnastyczna
library = biblioteka
office = sekretariat
playground = boisko do zabawy
science laboratory = sala do nauki biologii, chemii, fizyki
sports field = boisko sportowe
teachers' room| staff room = pokój nauczycielski
cloakroom = szatnia
common room = świetlica
locker = szafka
head teacher|headmaster = dyrektor / dyrektorka
professor = profesor, wykładowca akademicki
schoolboy|schoolgirl = uczeń|uczennica
schoolmate|classmate = kolega,koleżanka ze szkoły, z klasy
teacher = nauczyciel, nauczycielka
form teacher|tutor = wychowawca, wychowawczyni
teaching staff = grono pedagogiczne
bag|schoolbag = torba, tornister
blackboard|whiteboard|board = tablica
calculator = kalkulator
coloured pencils = kredki
copybook|notebook = zeszyt
dictionary = słownik
glue = klej
lunch box = pudełko na drugie śniadanie, obiad
pen długopis = pencil
case = piórnik
pencil = ołówek
rubber = gumka
ruler = linijka
scissors = nożyczki
textbook|coursebook = podręcznik
workbook = zeszyt ćwiczeń
class register = dziennik lekcyjny
PE kit = strój gimnastyczny
pupil's record book = dzienniczek ucznia
break|lunch break = przerwa|przerwa na lunch
extra activities = zajęcia dodatkowe
lesson|class = lekcja
parent-teacher meeting = wywiadówka
punish = karać
punishment = kara
school trip = wycieczka szkolna
school uniform = mundurek szkolny
summer holidays|winter holidays = wakacje / ferie
term = semestr
timetable = plan lekcji
assembly = apel
compulsory = obowiązkowy
education fair = targi szkolne
read set books = czytać lektury szkolne
class test = klasówka, sprawdzian
examination|exam = egzamin
fail an exam test|fail an a test = nie zdać egzaminu / testu
final exam = egzamin końcowy
get an A B/a C/ in a test|get an a B/a C/ in a test|get an A/a B C/ in a test|get an A/a a C/ in a test|get an A/a B/a C a test|get an A/a B/a in a test = dostać piątkę / czwórkę / trójkę / z testu
get the results of a test exam|get the results of a an exam = dostać wyniki testu / egzaminu
learn = uczyć się
mark|grade = stopień / ocena
pass an exam|pass an test = zdać egzamin / test
prepare for exams = przygotowywać się do egzaminów
revise|study for = powtarzać materiał do egzaminów
school-leaving exam = egzamin końcowy, na koniec szkoły
take an exam = przystępować do egzaminu
teach = uczyć kogoś
short test|spot test = kartkówka
test result = wynik testu
cheat in an exam = ściągać na egzaminie
crib = ściąga
school report = semestralny raport o wynikach w nauce, świadectwo szkolne
retake an exam = ponownie przystępować do egzaminu
lazy = leniwy
unfair = niesprawiedliwy
ambitious = ambitny
demanding = wymagający
gifted = uzdolniony
hard-working = pracowity
patient = cierpliwy
punctual = punktualny
strict = surowy
talented = utalentowany
tolerant = tolerancyjny
understanding = wyrozumiały
be good at sth|be bad at sth = być dobrym / złym z czegoś, w czymś
be late for school = spóźnić się do szkoły
copy homework = odpisać pracę domową
do an exercise project/a task|do an a project/a task|do an exercise/a project task|do an exercise/a a task = robić ćwiczenie / projekt / zadanie
do homework = odrabiać pracę domową
get into university = dostać się na uczelnię
have a break = zrobić sobie przerwę, mieć przerwę
have extra classes = mieć dodatkowe lekcje, zajęcia
leave school = skończyć szkołę
make mistakes = robić błędy
make notes|take notes = robić notatki
miss lessons = opuszczać lekcje
study hard = uczyć się pilnie
wear a school uniform = nosić mundurek
write an essay = pisać wypracowanie
be absent from school = być nieobecnym w szkole
be caught cheating = zostać złapanym na ściąganiu
belong to a club = należeć do kółka zainteresowań
do one's best = bardzo się starać
do well in an exam|do badly in an exam = dobrze / źle poradzić sobie na egzaminie
fall behind = mieć zaległości
hand in homework = oddawać pracę domową
learn by heart = uczyć się na pamięć
make progress = robić postępy
motivate students = motywować uczniów
pay attention = uważać na lekcji
play truant = wagarować
put the test off = przełożyć klasówkę
take active part in a lesson = brać aktywny udział w lekcji
take the register = sprawdzać listę

[Unit 4 Praca]
actor = aktor
actress = aktorka
architect = architekt, architektka
artist = artysta, artystka
babysitter = opiekun, opiekunka do dzieci
bus driver|taxi driver = kierowca autobusu / taksówkarz
computer programmer = programista, programistka
cook = kucharz, kucharka
dentist = dentysta, dentystka
doctor = lekarz, lekarka
electrician = elektryk
engineer = inżynier
factory worker = robotnik
farmer = rolnik
fashion designer = projektant, projektantka mody
film director = reżyser, reżyserka
firefighter = strażak
flight attendant = steward, stewardesa
hairdresser = fryzjer, fryzjerka
housewife = gospodyni domowa
librarian = bibliotekarz, bibliotekarka
manager = menedżer, menedżerka, kierownik, kierowniczka
mechanic = mechanik
model = model, modelka
musician = muzyk
nurse = pielęgniarz, pielęgniarka
painter = malarz, malarka
photographer = fotograf
pilot = pilot
policeman/police officer|policewoman/police officer = policjant, policjantka
postman = listonosz
postwoman = listonoszka
scientist = naukowiec
secretary = sekretarz, sekretarka
shop assistant = sprzedawca, sprzedawczyni
singer = śpiewak, śpiewaczka, wokalista, wokalistka
teacher = nauczyciel, nauczycielka
TV presenter = prezenter telewizyjny, prezenterka telewizyjna
vet = weterynarz
waiter = kelner
waitress = kelnerka
accountant = księgowy, księgowa
dressmaker = krawiec, krawcowa
journalist = dziennikarz, dziennikarka
judge = sędzia
lawyer = prawnik, prawniczka
miner = górnik
plumber = hydraulik
politician = polityk
security guard = ochroniarz
soldier = żołnierz
ticket inspector = kontroler, kontrolerka biletów
boring = nudny
dangerous = niebezpieczny
easy = łatwy
full-time = na pełny etat
hard = ciężki
important = ważny
interesting = ciekawy
part-time = w niepełnym wymiarze godzin
safe = bezpieczny
badly paid = źle płatny
demanding = trudny, wymagający
satisfying = satysfakcjonujący
stressful = stresujący
well-paid = dobrze płatny
army = wojsko
clinic = klinika
company = firma
factory = fabryka
farm = gospodarstwo rolne
hospital = szpital
lab|laboratory = laboratorium
library = biblioteka
office = biuro
post office = poczta
restaurant = restauracja
school = szkoła
shop = sklep
studio = studio
court of law = sąd
mine = kopalnia
design = projektować
deliver = dostarczać
drive a car lorry|drive a a lorry = prowadzić samochód / ciężarówkę
repair = naprawiać
save people = ratować ludzi
serve clients = obsługiwać klientów
work with a computer = pracować na komputerze
write emails|write reports = pisać e-maile / sprawozdania
dye hair = farbować włosy
take care of children = opiekować się dziećmi
earn = zarabiać
bonus = premia
pay rise = podwyżka
pension = emerytura (pieniądze)
salary = pensja miesięczna, roczna
unemployment benefit = zasiłek dla bezrobotnych
wage = zapłata tygodniowa, dniówka
career = zawód, kariera
find a job = znaleźć pracę
job = zawód, posada
job agency = biuro pośrednictwa pracy
job candidate = kandydat / kandydatka do pracy
job interwiew = rozmowa kwalifikacyjna
lose one's job = stracić pracę
on holiday = na urlopie
profession = zawód wysoko kwalifikowany
task = zadanie
be fired|get fired = zostać zwolnionym
deadline = termin wykonania pracy
employ = zatrudnić
give up work = rzucić pracę
pensioner = emeryt, emerytka, rencista, rencistka
post|position = stanowisko
retire = odejść na emeryturę, rentę
retirement = emerytura
shift = zmiana (np. nocna, ośmiogodzinna)
unemployed = bezrobotny
boss = szef, szefowa
colleague = kolega, koleżanka z pracy
employee = pracownik, pracownica
team = zespół
staff = personel
atmosphere = atmosfera
contact with people = kontakt z ludźmi
giving orders = wydawanie rozkazów, poleceń
helping people = pomaganie ludziom
success = sukces
job satisfaction = satysfakcja zawodowa
personal development = rozwój osobisty
prestige = prestiż
get a job = dostać pracę
finish a project successfully = pomyślnie zakończyć zadanie, projekt
work as = pracować jako
work for a company = pracować w firmie
do sth for a living = zarabiać na życie
follow a procedure = postępować zgodnie z procedurą
get promoted = dostać awans
go on strike = strajkować
look for a job = szukać pracy
open to new challenges = otwarty na nowe wyzwania
responsible for = odpowiedzialny za
turning point in one's career = punkt zwrotny w czyjejś karierze
work long hours = pracować wiele godzin dziennie

[Unit 5 Życie towarzyskie i rodzinne]
adult = dorosły
baby = niemowlę
be born = urodzić się
child = dziecko
children = dzieci
die = umrzeć
elderly = w podeszłym wieku
grow up = dorastać
kid = dzieciak
old = stary
middle-aged = w średnim wieku
teenager = nastolatek, nastolatka
young = młody
at the age of 16 = w wieku 16 lat
birth = narodziny
childhood = dzieciństwo
death = śmierć
generation = pokolenie
best friend = najlepszy przyjaciel, przyjaciółka
boyfriend = chłopak (sympatia)
date = randka
get divorced = rozwieść się
get engaged = zaręczyć się
get married to sb|marry sb = poślubić kogoś
girlfriend = dziewczyna (sympatia)
go out with sb = umawiać się z kimś na randki, chodzić z kimś
honeymoon = miesiąc miodowy
marriage = małżeństwo
married couple = para małżeńska
meet sb = poznać kogoś, spotkać się z kimś
bride = panna młoda
become pregnant = zajść w ciążę
fiance = narzeczony
fiancee = narzeczona
groom = pan młody
marriage proposal = oświadczyny
relationship = związek
do homework = odrabiać pracę domową
get dressed = ubierać się
get ready for bed|get ready for school = szykować się do spania / szkoły
get up = wstawać
go to bed early|go to bed late = położyć się spać wcześnie / późno
go to school/work|walk to school/work|go/walk to school|go/walk to work = iść do szkoły / pracy
have a meal = zjeść posiłek
have a rest = odpoczywać
have breakfast/tea/dinner|have lunch/tea/dinner|have breakfast/lunch/tea|have breakfast/lunch/dinner = jeść śniadanie / lunch / podwieczorek / obiad
make one's bed = posłać łóżko
make meals|prepare meals = przygotowywać posiłki
take the children to school = zaprowadzić, zawieźć dzieci do szkoły
take the dog for a walk = wyprowadzić psa na spacer
take a bath|have a bath = wziąć kąpiel
take a shower|have a shower = wziąć prysznic
wake up = budzić się
do sports = uprawiać sporty
go for a walk = iść na spacer
go out = wychodzić np. do kina, restauracji
go shopping = iść na zakupy
go swimming/bowling|go dancing/bowling = iść pływać / tańczyć / na kręgle
go to a party = iść na przyjęcie
go to a shopping centre = iść do centrum handlowego
go to the cinema disco/a concert|go to the a disco/a concert|go to the cinema/a disco concert|go to the cinema/a a concert = iść do kina / dyskoteki / na koncert
have a hobby = mieć hobby
have little free time = mieć mało wolnego czasu
have a party = wydawać przyjęcie
listen to music the radio|listen to to the radio = słuchać muzyki / radia
meet friends = spotykać się z przyjaciółmi
play cards games/chess|play board games/chess|play cards/board games|play cards/board chess = grać w karty / gry planszowe / szachy
play the piano guitar|play the the guitar = grać na pianinie / gitarze
play video games|play computer games = grać w gry wideo / komputerowe
read books/comics|read magazines/comics = czytać książki / czasopisma / komiksy
spend time outdoors = spędzać czas na powietrzu
surf the Internet Net|surf the the Net = surfować w Internecie
watch TV video/a film|watch a video/a film|watch TV/a video film|watch TV/a a film = oglądać telewizję / wideo / film
weekend plans = plany na weekend
aunt = ciotka
brother = brat
cousin = kuzyn|kuzynka|brat cioteczny|siostra cioteczna
daughter = córka
father = ojciec
grandchildren = wnuki
granddaughter = wnuczka
grandfather = dziadek
grandmother = babcia
grandparents = dziadkowie
grandson = wnuk
great-granddaughter = prawnuczka
great-grandchildren = prawnuki
great-grandfather = pradziadek
great-grandmother = prababcia
great-grandson = prawnuczek
husband = mąż
mother = matka
parents = rodzice
sister = siostra
son = syn
stepbrother = brat przyrodni
stepfather = ojczym
stepmother = macocha
stepsister = siostra przyrodnia
uncle = wujek
wife = żona
adopted = adoptowany
adoption = adopcja
father-in-law = teść
mother-in-law = teściowa
nephew = siostrzeniec, bratanek
niece = siostrzenica, bratanica
only child = jedynak,jedynaczka
orphan = sierota
relative = krewny
twins = bliźniaki
birthday cake = tort urodzinowy
birthday present = prezent urodzinowy
birthday = urodziny
give presents|get presents = dawać / dostawać prezenty
wedding = ślub
blow out candles = zdmuchiwać świeczki
cards = kartki (świąteczne)
carols = kolędy
celebrate = obchodzić uroczystości, świętować
celebration = uroczystość
champagne = szampan
Christmas = święta Bożego Narodzenia
Christmas Day = pierwszy dzień świąt Bożego Narodzenia
Christmas Eve = Wigilia
confetti = konfetti
decorate the Christmas tree = ubierać choinkę
Easter = Wielkanoc
Easter bunny = króliczek wielkanocny
fancy dress party = bal przebierańców
festival|holiday = święto
fireworks = sztuczne ognie
funeral = pogrzeb
Mother's's Day|Mother'Father's Day = Dzień Matki / Ojca
New Year's Day = Nowy Rok
New Year's Eve = Sylwester
wedding anniversary = rocznica ślubu
wedding reception = przyjęcie weselne
argue with sb = kłócić się z kimś
argument = kłótnia
break up with sb = zerwać z kimś
destroy a friendship = zniszczyć przyjaźń
generation gap = konflikt pokoleń
hate sb = nienawidzić kogoś
have an argument row with sb|have an a row with sb = kłócić się z kimś
make up with sb = pogodzić się z kimś
run away from home = uciec z domu
split up = rozstać się
bring up children = wychowywać dzieci
enjoy oneself|have a good time|have fun = dobrze się bawić
get on well with sb = być w dobrych relacjach z kimś
look after|take care of sb = opiekować się kimś
take care of children = opiekować się dziećmi

[Unit 6 Żywienie]
biscuits|cookies = herbatniki, ciasteczka
cake = ciasto
chocolate = czekolada
chocolates = czekoladki
honey = miód
jam = dżem
sweets = słodycze
apple pie = szarlotka
cheesecake = sernik
doughnut|donut = pączek
beans = fasola
carrot = marchewka
garlic = czosnek
green peas = groszek
green pepper|red pepper = zielona / czerwona papryka
mushrooms = grzyby
onion = cebula
potato = ziemniak
tomato = pomidor
vegetable = warzywo
cucumber = ogórek
lettuce = sałata
olives = oliwki
sweetcorn = kukurydza
bacon = bekon
chicken = kurczak
ham = szynka
meat = mięso
salami = salami
sausage = kiełbasa
steak = stek
turkey = indyk
cold meats = wędliny
lamb = jagnięcina
pork = wieprzowina
fish = ryba
herring = śledź
salmon = łosoś
seafood = owoce morza
tuna = tuńczyk
bread = chleb
breakfast cereals = płatki śniadaniowe
pasta = makaron
rice = ryż
toast = tost
cereal products = produkty zbożowe
croissant = rogalik
noodles = kluski
roll = bułka
coffee = kawa
cola = cola
drink = napój
hot chocolate = czekolada na gorąco
juice = sok
tea = herbata
fizzy drinks = napoje gazowane
soft drinks = napoje bezalkoholowe
sparkling mineral water|still mineral water = gazowana / niegazowana woda mineralna
apple = jabłko
banana = banan
fruit = owoce
lemon = cytryna
pineapple = ananas
strawberry = truskawka
cherry = wiśnia
peach = brzoskwinia
pear = gruszka
plum = śliwka
watermelon = arbuz
butter = masło
cheese = ser
eggs = jajka
ice cream = lody
milk = mleko
yoghurt = jogurt
cottage cheese = twarożek
cream = śmietana
dairy products = nabiał
crisps = czipsy, chrupki
ketchup = keczup
mustard = musztarda
olive oil = oliwa z oliwek
pepper = pieprz
salt = sól
spices = przyprawy
sugar = cukier
toppings = dodatki do pizzy
flour = mąka
vinegar = ocet
bag of flour = torebka mąki
bar of chocolate = tabliczka czekolady
bottle of juice = butelka soku
box of chocolates = pudełko czekoladek
can of cola = puszka coca-coli
carton of milk = karton mleka
cup of tea = filiżanka herbaty
glass of water = szklanka wody
packet of breakfast cereals = paczka płatków śniadaniowych
clove of garlic = ząbek czosnku
jar of jam = słoik dżemu
loaf of bread = bochenek chleba
slice of cheese = plasterek sera
tin of green peas = puszka groszku
boil = wrzeć, gotować
cook = gotować
cut = siekać, kroić
mix = mieszać (kilka składników)
plate = talerz
serve = podawać
tablespoon = łyżka stołowa
teaspoon = łyżka do herbaty
tomato sauce = sos pomidorowy
vegetarian = wegetarianin, wegetariański
wash = umyć
add = dodawać
bake = piec
beat = ubijać
bowl = miska
chop = siekać, ciąć na kawałki
fry = smażyć
frying pan = patelnia
grill = grillować
heat = podgrzać
ingredient = składnik
kettle = czajnik
melt = topić, rozpuszczać
mixture = mieszanina
oven = piekarnik
peel = obierać
pour = nalewać
ready-made pizza base = gotowe ciasto do pizzy
recipe = przepis
roast = piec mięso
slice = plasterek, kromka, ciąć na plasterki
spread = rozprowadzić (np. masło na kanapce)
stir = mieszać (jedną substancję)
fresh = świeże
salty = słone
spicy|hot = ostre, pikantne
sweet = słodkie
tasty = smaczne
delicious = wyśmienite, przepyszne
disgusting = okropne
fattening = tuczące
fatty = tłuste
medium/well-done steak|rare/well-done steak = średnio krwisty / surowy / dobrze wysmażony stek
sour = kwaśne
stale = czerstwe
bar = bar
bill = rachunek
cafe = kawiarnia
cafeteria|canteen bar|bufet = stołówka
chef = kucharz, kucharka
course = danie (część posiłku)
dessert = deser
fast food restaurant = bar szybkiej obsługi
fork = widelec
knife = nóż
menu = karta dań
napkin = serwetka
on the menu = w karcie dań
order = zamówić
pizzeria = pizzeria
restaurant = restauracja
self-service restaurant = bar samoobsługowy
service = obsługa
spoon = łyżka
starter = przystawka
tip = napiwek
waiter = kelner
waitress = kelnerka
cutlery = sztućce
drive-through bar|drive-thru = bar dla kierowców
main course = danie główne
staff = personel
takeaway = jedzenie na wynos, restauracja sprzedająca jedzenie na wynos
boiled eggs = jajka gotowane
chips|French fries = frytki
dish = danie
omelette = omlet
salad = sałatka
sandwich = kanapka
soup = zupa
fried eggs = jajka sadzone
scrambled eggs = jajecznica
breakfast = śniadanie
brunch = drugie śniadanie
dessert = deser
dinner = obiad, kolacja
lunch = lunch
meal = posiłek
supper = kolacja
tea = podwieczorek
Are you ready to order? = Czy jest pan, pani gotowy, gotowa do złożenia zamówienia?
cook a meal = ugotować posiłek
Enjoy your meal! = Smacznego!
fast food|junk food = niezdrowe jedzenie
have a meal = jeść posiłek
home-made meals = posiłki domowe
unhealthy food = niedrowa żywność
be on a diet = być na diecie
book a table = zarezerwować stolik
Could you pass me the salt, please? = Czy mógłbyś mi podać sól?
Do you take sugar in your tea? = Czy słodzisz?
eat out = jeść poza domem
Help yourself to ... = Poczęstuj się...
How would you like your steak? = Jak ma być przyrządzony stek?
lay the table = nakryć do stołu
put on weight = przybierać na wadze
take sb's order = przyjąć zamówienie
varied meals = urozmaicone posiłki

[Unit 7 Zakupy i usługi]
baker's = piekarnia
bookshop = księgarnia
butcher's = sklep mięsny
chemist's|pharmacy = apteka
clothes = shop sklep z ubraniami
farmers' market = rynek, targ
flower shop = kwiaciarnia
grocer's = sklep spożywczy
music shop = sklep muzyczny
newsagent's = kiosk z gazetami
shoe shop = sklep obuwniczy
shopping centre|mall = centrum handlowe
sports shop = sklep sportowy
supermarket = supermarket
bazaar = bazar
fishmonger's = sklep rybny
furniture shop = sklep meblowy
greengrocer's = warzywniak
second-hand shop = sklep z używanymi rzeczami
stall = stoisko na targu
stationer's = sklep z artykułami papierniczymi
basket = koszyk
buy = kupić
change = reszta, rozmienić
cheap = tani
checkout = kasa w supermarkecie
choice = wybór
cost = kosztować
customer = klient
expensive = drogi
fresh = świeży
price = cena
products|goods = produkty, towary
producer = producent
queue = stać w kolejce, kolejka
sell = sprzedać
shop assistant = sprzedawca
shopping list = lista zakupów
trolley = wózek na zakupy
advise = doradzić
afford = móc pozwolić sobie na coś
bargain = okazja (dobry produkt za niską cenę)
checkout assistant = kasjer, kasjerka
convenient = dogodny
receipt = paragon, kwit
second-hand = używany
shopaholic = osoba uzależniona od zakupów
changing room = przymierzalnia
fashionable|trendy = modne
go shopping = iść na zakupy
I'm a size 12 = Noszę rozmiar 12
the latest fashion = najnowsza moda
the right size = odpowiedni rozmiar
too small|too big = zbyt mały / duży
try sth on = przymierzać coś
sale = wyprzedaż
designer clothes = modne, markowe ubrania
loose = luźny
tight = ciasny
complain = składać reklamację, zażalenie
broken = zepsuty
doesn't work = nie działa
get one's money|have one's money = back otrzymać zwrot pieniędzy
is missing = brakuje...
repair = naprawiać
return sth = oddać, zwrócić coś
speak to the manager|talk to the manager = rozmawiać z kierownikiem sklepu
dissatisfied = niezadowolony
exchange sth for sth else = wymienić jedną rzecz na drugą
make a complaint = złożyć reklamację
quality = jakość
advertisement|advert|ad = reklama, ogłoszenie
bank = bank
car wash = myjnia samochodowa
cash machine = bankomat
hairdresser's = fryzjer
petrol station = stacja benzynowa
photographer's = fotograf
post office = poczta
service = usługa
service station|garage = stacja obsługi, warsztat samochodowy
dry cleaner's = pralnia chemiczna
advertise = reklamować, zachęcać do kupienia
advertising break = przerwa na reklamy
advertising campaign = kampania reklamowa
billboard = billboard
logo = logo
sponsor = sponsor
brand name = nazwa firmowa, marka
brochure = broszura
commercial = reklama radiowa i telewizyjna
hoarding = billboard
leaflet|flyer = ulotka reklamowa
marketing strategy = strategia marketingowa
poster = plakat
slogan = hasło reklamowe
Anything else? = Czy coś jeszcze?
buy in a sale = kupić na wyprzedaży
How can I help you? = Czym mogę służyć?
How much is ...? = Ile kosztuje...?
look for sth = szukać czegoś
pocket money = kieszonkowe
save money = oszczędzać pieniądze
spend money = wydawać pieniądze
That's £20 altogether = Płaci pan, pani 20 funtów za wszystko
20 per cent discount|20 per cent off = 20 procent rabatu
browse = szukać, przeglądać, rozglądać się
buy at half price = kupować za połowę ceny
buy things on-line = kupić rzeczy przez Internet
for sale = na sprzedaż
get sth free = dostać coś za darmo
have (not) enough money on me = mieć wystarczająco / niewystarczająco pieniędzy przy sobie
on special offer = w ofercie specjalnej, promocyjnej
pay by credit card = płacić kartą kredytową
pay in cash = płacić gotówką

[Unit 8 Podróżowanie i turystyka]
bicycle|bike = rower
boat = łódź
bus = autobus
car = samochód osobowy
helicopter = helikopter
means of transport = środki transportu
motorbi ke|motorcycle = motocykl
plane = samolot
port = port
ship = statek
take a train plane|take a a plane = pojechać pociągiem / polecieć samolotem
taxi|cab = taksówka
train = pociąg
travel by train|travel by bus = podróżować pociągiem / autobusem
underground|tube|subway = metro
coach = autokar
ferry = prom
railway = kolej
tram = tramwaj
airport = lotnisko
underground station = stacja metra
coach station = dworzec autokarowy
ferry terminal = przystań promowa
railway station = dworzec kolejowy
taxi rank = postój taksówek
backpacker = turysta wędrujący z plecakiem
camper = obozowicz, biwakowicz
tourist = turysta
traveller = podróżnik
globetrotter = globtroter, obieżyświat
hitchhiker = autostopowicz
passenger = pasażer
travel agent = pracownik biura podróży
change trains/buses|change planes/buses = przesiadać się
gate = wyjście prowadzące do samolotu
hand luggage|hand baggage = bagaż podręczny
journey = podróż
land = lądować
platform = peron
return ticket = bilet powrotny
sail = żeglować
single ticket = bilet w jedną stronę
special offer = oferta specjalna
suitcase = walizka
ticket office = kasa biletowa
timetable = rozkład jazdy
travel = podróż, podróżować
travel agency = biuro podróży
travel around the world = podróżować dookoła świata
trip = wycieczka
arrive = przyjeżdżać
board = pokład
compartment = przedział
cruise = rejs wycieczkowy
delayed = opóźniony
depart = odlatywać, odjeżdżać
duty-free shop = sklep wolnocłowy
excursion = wycieczka
flight = lot
flight attendant = steward, stewardesa
foreign currency = obca waluta
lower deck = dolny pokład
tour = wycieczka objazdowa
voyage = podróż morska
weigh = ważyć
adventure holiday = wczasy dla amatorów aktywnego wypoczynku
backpacking = wędrówka z plecakiem
beach holiday = wakacje na plaży
camping holiday = wakacje pod namiotem
go to the seaside the mountains/to the country|go to the to the mountains/to the country|go to the seaside/to the mountains the country|go to the seaside/to the to the country = pojechać nad morze / w góry / na wieś
stay at home = zostać w domu
winter holidays = ferie zimowe
package holiday = wakacje zorganizowane
art gallery = galeria sztuki
beach = plaża
beautiful views = piękne widoki
camp = obóz
car racing = wyścigi samochodowe
climbing = wspinaczka
cycling = jazda na rowerze
diving = nurkowanie
fishing = wędkowanie
ice-skating = jazda na łyżwach
postcard = pocztówka
sand = piasek
sightseeing = zwiedzanie
skiing = jazda na nartach
snowboarding = jazda na snowboardzie
souvenir shop = sklep z pamiątkami
sunbathing = opalanie się
swimming = pływanie
tourist attractions = atrakcje turystyczne
visit = odwiedzać
windsurfing = windsurfing
current = prąd
dog sledging = zaprzęgi psów
explore = zbadać (teren, możliwości)
hiking = piesze wycieczki, wędrówki
hitchhiking = jazda autostopem
snorkelling = nurkowanie z rurką
campsite = pole namiotowe, kemping
double room = pokój dwuosobowy z podwójnym łóżkiem
hotel = hotel
reception = recepcja
receptionist = recepcjonista, recepcjonistka
single room = pokój jednoosobowy
tent = namiot
youth hostel = schronisko młodzieżowe
accommodation = zakwaterowanie
B&B (bed and breakfast) = pokoje gościnne (nocleg i śniadanie)
cabin = kabina na statku
caravan = przyczepa kampingowa
family-run place = hotel, pensjonat prowadzony przez rodzinę
guesthouse = pensjonat
mountain shelter = schronisko górskie
camera = aparat fotograficzny
compass = kompas
guidebook = przewodnik
lighter = zapalniczka
map = mapa
matches = zapałki
phrase book = rozmówki
raincoat = płaszcz przeciwdeszczowy
rucksack|backpack = plecak
skis = narty
sun cream = krem do opalania
sun hat = kapelusz od słońca
sunglasses = okulary przeciwsłoneczne
umbrella = parasol
equipment = wyposażenie, ekwipunek
flippers = płetwy
rope = lina
sleeping bag = śpiwór
snorkel = rurka do nurkowania
swimsuit = kostium kąpielowy
torch = latarka
cross the street = przejść przez ulicę
go across = przejść przez
go along a street = iść wzdłuż ulicy
go past = przejść obok
go straight on = iść prosto
go as far as the traffic lights|walk as far as the traffic lights = iść aż do świateł
on the corner = na rogu
on the right|on the left = po prawej / lewej stronie
take the first turning|take the second turning = skręcić w pierwszą / drugą przecznicę
tourist information office = biuro informacji turystycznej
turn right at the hotel|turn left at the hotel = skręcać w prawo / lewo przy hotelu
ask sb the way|show sb the way = pytać o / wskazywać komuś drogę
directions = wskazówki
accident = wypadek
get lost = zgubić się
lose one's luggage = zgubić bagaż
break down = zepsuć się (o pojeździe)
emergency = nagły wypadek, sytuacja kryzysowa, awaria
feel seasick = cierpieć na chorobę morską
get stuck in a traffic jam = utknąć w korku
get travel-sick = dostać choroby lokomocyjnej
have a flat = tyre złapać gumę
life jacket = kamizelka ratunkowa
lifeboat = łódź ratunkowa
miss one's flight|miss one's plane = spóźnić się na lot / samolot
sb ran out of petrol = komuś skończyła się benzyna
check in at the airport = zgłosić się do odprawy na lotnisku
check in at the hotel|check out at the hotel = zameldować się / wymeldować się z hotelu
check-in desk = stanowisko odprawy bagażowej
exchange money = wymieniać pieniądze
go on holiday = pojechać na wakacje
make a fire = rozpalić ognisko
on foot = pieszo
stay in a hotel = zatrzymać się na noc w hotelu
travel abroad = podróżować za granicę
baggage reclaim = odbiór bagażu
book a flight = zarezerwować lot
bureau de change = kantor wymiany walut
departure lounge = hala odlotów
fasten seatbelts = zapiąć pasy
get on|get off = wsiadać do / wysiadać z pociągu, autobusu, promu
give sb a lift = podwieźć kogoś
Have a safe trip!|Have a safe journey! = Bezpiecznej podróży!
left-luggage office = przechowalnia bagażu
make a reservation = zrobić rezerwację
put up a tent = rozbić namiot
take off = wystartować (o samolocie)

[Unit 9 Kultura]
create = tworzyć
dialogue = dialog, dialogi
hero = bohater
heroine = bohaterka
main character = główny bohater, główna bohaterka
recommend sth to sb = polecać coś komuś
review = recenzja
entertain = zabawiać
entertaining = rozrywkowy
entertainment = rozrywka
event = wydarzenie
masterpiece = arcydzieło
plot = akcja, fabuła
artist = artysta, artystka
art gallery = galeria sztuki
drawing = rysunek
modern art = sztuka nowoczesna
paint = malować
painter = malarz, malarka
painting = obraz
photograph = zdjęcie, fotografia
photographer = fotograf
photography = fotografia
portrait = portret
studio = pracownia
take photographs = robić zdjęcia
a work of art = dzieło sztuki
abstract art = sztuka abstrakcyjna
design = projektować
designer = projektant, projektantka
draw in pencil|draw in chalk = rysować ołówkiem / kredą
exhibition = wystawa
landscape = pejzaż
sculptor = rzeźbiarz, rzeźbiarka
sculpture = rzeźba
self-portrait = autoportret
stili life = martwa natura
band|group = zespół muzyczny
classical music = muzyka poważna
concert = koncert
concert hall = sala koncertowa
drums = perkusja
folk music = muzyka folk
guitar = gitara
guitarist = gitarzysta, gitarzystka
hip-hop = muzyka hip-hopowa
hit = przebój
jazz = muzyka jazzowa
modern music = muzyka nowoczesna
musician = muzyk
opera = opera
orchestra = orkiestra
piano = fortepian
play an instrument = grać na instrumencie
pop music = muzyka popularna
record = płyta
rock music = muzyka rockowa
sing = śpiewać
singer = piosenkarz, piosenkarka
song = piosenka
tour = tournee
violin = skrzypce
award = nagroda
composer = kompozytor, kompozytorka
conduct = dyrygować
conductor = dyrygent, dyrygentka
lyrics = tekst piosenki
release a single album|release a an album = wydać singiel / album
bestseller = bestseler
chapter = rozdział
detective story = kryminał
fairy tale = baśń
fiction = beletrystyka, literatura piękna
love story = historia miłosna, romans
Nobel Prize = Nagroda Nobla
non-fiction = literatura faktu
novel = powieść
poem = wiersz
poet = poeta, poetka
poetry = poezja
short story = opowiadanie
writer = pisarz, pisarka
volume = tom
limerick = limeryk
rhyme = rym, rymować się
act = akt, grać
actor = aktor
actress = aktorka
cast = obsada aktorska, obsadzać w filmie, sztuce
performance = przedstawienie
play = sztuka teatralna
programme = program
seat = miejsce w teatrze
stage = scena
applaud = oklaskiwać
applause = oklaski
box office = kasa biletowa
interval = antrakt
action film = film akcji
cartoon = film rysunkowy, kreskówka
cinema = kino
direct = reżyserować
director = reżyser, reżyserka
disaster movie = film katastroficzny
film|movie = film
horror film = horror
make a film = robić film
musical = musical
romantic comedy = komedia romantyczna
sci-fi|science fiction film = film science fiction
special effects = efekty specjalne
thriller = thriller
western = western
audience = widownia
blockbuster = przebój filmowy
documentary = film dokumentalny
dubbed film = dubbingowany
dubbing = dubbing
feature film = pełnometrażowy film fabularny
main role|leading role = główna rola
producer = producent filmowy, producentka filmowa
scene = scena
shoot = kręcić, filmować
shot = kadr
soundtrack = ścieżka dźwiękowa
spectator = widz
star in a film = grać, występować w filmie
subtitled film = z napisami
subtitles = napisy
disappointing = rozczarowujący
disgusting = okropny
fascinating = fascynujący
interesting = interesujący
realistic = realistyczny
surprising = zaskakujący
amusing = zabawny
inspiring = inspirujący
thrilling = ekscytujący
touching = wzruszający
unimaginative = bez wyobraźni
interview = wywiad, przeprowadzać wywiad
journalist = dziennikarz, dziennikarka
news = wiadomości
reporter = reporter, reporterka
censorship = cenzura
correspondent = korespondent, korespondentka
gossip = plotki
comedy programme = program komediowy
educational programme = program edukacyjny
game show = teleturniej
music video|video clip = teledysk
presenter = prezenter, prezenterka
quiz show = teleturniej
reality show = reality show
sports programme = program sportowy
station = stacja
talk show = talk show
commercial = reklama telewizyjna, radiowa
episode = odcinek
newsreader = prezenter, prezenterka wiadomości
radio drama = słuchowisko radiowe
sitcom = sitcom
soap opera = telenowela
viewer = widz
article = artykuł
magazine = czasopismo
newspaper = gazeta
readers' letters = listy od czytelników
teen magazine = magazyn dla nastolatków
women's magazine = czasopismo kobiece
agony aunt column = rubryka z poradami
celebrity = znana osoba
colour supplement = kolorowy dodatek
daily = dzieenik
weekly = tygodnik
monthly = miesięcznik
gossip column = rubryka plotkarska
quality press|quality paper = prasa / gazeta poważna
tabloid = brukowiec
be famous for = być znanym z czegoś
the film was directed by ... = reżyserem filmu jest...
on the radio = w radiu
on TV = w telewizji
based on a book true story|based on a a true story = oparty na książce / prawdziwej historii
the book/story is set in|the film/story is set in = książka / film jest osadzona w...
come out|publish = wyjść, ukazać się
the film tells the story of|the book tells the story of = film / książka przedstawia historię...
it's worth seeing = warto zobaczyć
play the part of sb|play the role of sb = grać rolę kogoś
reliable source of information = niezawodne źródło informacji
what's on ...? = co jest aktualnie grane w telewizji / teatrze / kinie?

[Unit 10 Sport]
athletics = lekkoatletyka
baseball = bejsbol
basketball = koszykówka
boxing = boks
cycling = kolarstwo
discipline = dyscyplina
figure skating|speed skating = łyżwiarstwo figurowe / szybkie
football|soccer = piiłka nożna
golf = golf
gymnastics = gimnastyka
ice hockey = hokej na lodzie
individual sports|team sports = sporty indywidualne / zespołowe
judo = dżudo
marathon = maraton
race = wyścig, bieg
rugby = rugby
sailing = żeglarstwo
skateboarding = jazda na deskorolce
skiing = narciarstwo
swimming = pływanie
table tennis = tenis stołowy
tennis = tenis
volleyball = siatkówka
20 km walk = chód na 20 km
water sports = sporty wodne
windsurfing = windsurfing
yoga = joga
car racing = wyścigi samochodowe
diving = nurkowanie
horseracing = wyścigi konne
indoor sports|outdoor sports = sporty halowe / na świeżym powietrzu
long jump|high jump = skok wzwyż / w dal
long-distance running = biegi długodystansowe
ski jumping = skoki narciarskie
rollerblading = jazda na łyżworolkach
weightlifting = podnoszenie ciężarów
bungee jumping = skoki na linie z dużej wysokości
extreme skiing = narciarstwo ekstremalne
extreme sports = sporty ekstremalne
hang-gliding = paralotniarstwo
sky surfing = serfowanie w przestrzeni
white water rafting = spływ po rzece
ball = piłka
boxing gloves = rękawice bokserskie
football boots = korki
football kit = strój do gry w piłkę nożną
goal = bramka
helmet = kask
net = siatka
skateboard = deskorolka
skates = łyżwy
skis = narty
swimming costume = kostium kąpielowy
swimming trunks = kąpielówki
swimming cap = czepek
swimming goggles = gogle, okulary ochronne
tennis racket = rakieta do tenisa
tracksuit = dres
trainers = buty sportowe
rollerblades = łyżworolki
wet suit = pianka do windsurfingu
whistle = gwizdek
boxer = bokser
cyclist = kolarz
footballer = piłkarz
golfer = golfista, golfistka
gymnast = gimnastyk, gimnastyczka
jumper = skoczek
marathon runner = maratończyk
runner = biegacz, biegaczka
skater = łyżwiarz, łyżwiarka
skier = narciarz, narciarka
swimmer = pływak, pływaczka
windsurfer = windsurfer
diver = nurek
goalkeeper = bramkarz
ski-jumper = skoczek narciarski
captain = kapitan
coach = trener
crowd = tłum
professional = zawodowiec
referee|umpire = sędzia sportowy
spectator = widz
supporter|fan = kibic
team = drużyna
amateur = amator
athlete = sportowiec
champion = mistrz
opponent = przeciwnik
attack = atakować
cheer = wiwatować, wznosić okrzyki, kibicować
compete = współzawodniczyć, konkurować
competition = konkurencja, zawody
defend = bronić
draw = remis
fight = walczyć
first half|second half = pierwsza / druga połowa
game = gra, mecz, gem
give up = poddawać się
gold/bronze medal|silver/bronze medal = złoty / srebrny / brązowy medal
kick = kopać
loss = przegrana
match = mecz
Olympic games|Olympics = Olimpiada
Olympic sport = sport olimpijski
penalty = rzut karny
points = punkty
practice = trening
practise = trenować, ćwiczyć
support = dopingować
tournament = turniej
train = trenować
victory = zwycięstwo
beat = pokonać
contest = zawody
contestants = zawodnicy
final = finał
semi-final = półfinał
half-time = pierwsza połowa meczu
round = runda
score = wynik meczu
World Cup = mundial
World championships|European championships = mistrzostwa świata / Europy
boxing ring = ring bokserski
court = kort do tenisa, boisko do koszykówki, siatkówki
gym|gymnasium = sala gimnastyczna, siłownia
skating rink = lodowisko
stadium = stadion
swimming pool = basen
football pitch = boisko do piłki nożnej
do a sport = uprawiać sport
do yoga/karate/athletics|do aerobics/karate/athletics|do yoga/aerobics/karate|do yoga/aerobics/athletics = uprawiać jogę / aerobik / karate / lekkoatletykę
go swimming/rollerblading|go cycling/rollerblading = ływać / jeździć na rowerze / jeździć na łyżworolkach
lose a game/race|lose a match/race = przegrać mecz / wyścig
play tennis/bridge|play football/bridge = grać w tenisa / piłkę nożną / brydża
win a game/race|win a match/race = wygrać grę / mecz / wyścig
be in the lead = być na prowadzeniu
keep fit = utrzymywać formę
knock sb out = znokautować kogoś
miss a kick|miss a goal = chybić
score a point goal|score a a goal = zdobyć punkt / strzelić gola
set a record = ustanowić rekord
break a record = pobić rekord
take up a sport = zacząć uprawiać sport
work out at the gym = ćwiczyć na siłowni

[Unit 11 Zdrowie]
accident = wypadek
bandage = bandaż
black eye = podbite oko
break = złamać, złamanie
burn = oparzyć się, poparzyć się, oparzenie
cut = zaciąć się, przeciąć, zacięcie
health = zdrowie
hospital = szpital
hurt = zranić, boleć; uszkodzić
bleed = krwawić
disabled = niepełnosprawny
first-aid kit = apteczka
injure|injury = zranić, odnieść kontuzję, zranienie, kontuzja
injured = zraniony, kontuzjowany
wheelchair = wózek inwalidzki
wound = rana
wounded = zraniony
allergy = alergia
backache = ból pleców
cold = przeziębienie
cough = kaszel, kaszleć
earache = ból ucha
feel terrible = czuć się okropnie
fever = gorączka
flu = grypa
have a sore throat = mieć bolące gardło
headache = ból głowy
heart attack = zawał, atak serca
ill = chory
illness = choroba
pain = ból
runny nose = katar
stomachache = ból brzucha
toothache = ból zęba
asthma = astma
be travel-sick|get travel-sick = cierpieć na chorobę lokomocyjną
be seriously ill = być poważnie chorym
breathing problems = problemy z oddychaniem
cancer = rak
check-up = badanie kontrolne u lekarza
chest pain = ból w klatce piersiowej
deaf = głuchy
feel ill = czuć się źle
feel sick = mieć mdłości
food poisoning = zatrucie pokarmowe
have the hiccups|get the hiccups = mieć czkawkę
hiccups = czkawka
painful = bolesny
pneumonia = zapalenie płuc
rash = wysypka
sleeplessness = bezsenność
sneeze = kichać
sweat = pot, pocić się
throw up|vomit = wymiotować
ambulance = karetka pogotowia
aspirin = aspiryna
blood = krew
blood group = grupa krwi
breath = oddech
cough medicine = lekarstwo na kaszel, syrop
cream = maść
dentist = stomatolog
doctor = lekarz
drugstore = apteka
emergency = nagły wypadek
go to hospital = iść do szpitala
have a high temperature = mieć wysoką temperaturę
lie down = położyć się
medication|medicine|drugs = lekarstwo
nurse = pielęgniarka
operation = operacja
optician = optyk
patient = pacjent, pacjentka
pill = pigułka, tabletka
pharmacy|chemist's = apteka
put cream on = posmarować maścią
stay in bed = pozostać w łóżku
symptoms = objawy, symptomy
thermometer = termometr
be overweight = być otyłym, mieć nadwagę
bite = ukąszenie, ugryzienie
blood pressure = ciśnienie krwi
bruise = siniak, stłuczenie
breathe in|breathe out = wdychać / wydychać powietrze
cure = wyleczyć, lekarstwo
disability = niesprawność
drops = krople
examine = badać
faint = zemdleć
feel dizzy = mieć zawroty głowy
get sunburnt = doznać poparzenia słonecznego
GP|General Practitioner = lekarz rodzinny
heart rate = tętno
infection = infekcja
injection = zastrzyk
operating theatre = sala operacyjna
painkillers = środki przeciwbólowe
plastic surgery = operacja plastyczna
prescribe = przepisać leki
prescription = recepta
scalpel = skalpel
scar = blizna
surgeon = chirurg
swallow = połykać, przełykać
treat = leczyć
ward = oddział w szpitalu
vaccine = szczepionka
X-ray = rentgen
appetite = apetyt
avoid stressful situations = unikać sytuacji stresujących
cut down on = zredukować, ograniczyć
get enough sleep = sypiać odpowiednią liczbę godzin
give up smoking = rzucić palenie
go on a diet = przejść na dietę
include sth in your diet = włączyć do swojej diety
keep fit|stay fit = utrzymywać dobrą formę
take exercise = ćwiczyć
work out in the gym = ćwiczyć na siłowni
bone = kość
brain = mózg
heart = serce
muscles = mięśnie
stornach = żołądek
kidney = nerka
liver = wątroba
lungs = płuca
spine = kręgosłup
transplant = przeszczep, przeszczepiać
alcoholic = alkoholik
addiction = uzależnienie
addictive = uzależniający
be addicted to|get addicted to = być uzależnionym od / uzależnić się
drug addict = osoba uzależniona od narkotyków
overdose = przedawkować
smoking = palenie papierosów
shopaholic = osoba uzależniona od robienia zakupów
workaholic = pracoholik
fall ill = zachorować
get better = wyzdrowieć
Is it serious? = Czy to coś poważnego?
What seems to be the problem?|What's the matter?|What's wrong? = Co panu, pani dolega?
be allergic to = być uczulonym na
catch a cold = przeziębić się
get a prescription|give a prescription = dostać / dawać receptę
hold one's breath = wstrzymać oddech
make an appointment with see a doctor|make an appointment to see a doctor = umawiać się na wizytę lekarską
my arm hurts a lot = bardzo boli mnie ręka
operate on = przeprowadzać operację
put on weight = przybierać na wadze
put sb's leg in plaster = założyć gips na nogę
recover from = dochodzić do siebie po czymś, wyzdrowieć
send sb to hospital for treatment = wysłać kogoś do szpitala na leczenie
suffer from = chorować, cierpieć z powodu
take sb's blood pressure = zmierzyć komuś ciśnienie
take sb's temperature = zmierzyć komuś temperaturę
twist one's ankle = skręcić kostkę
visit a doctor = pójść do lekarza

[Unit 12 Nauka i technika]
biologist = biolog
biology = biologia
chemist = chemik
chemistry = chemia
computer science = informatyka
computer scientist = informatyk
historian = historyk
history = historia
mathematician = matematyk
mathematics|maths = matematyka
physicist = fizyk
physics = fizyka
archaeologist = archeolog
archaeology = archeologia
astronomer = astronom
astronomy = astronomia
geneticist = genetyk
genetics = genetyka
discover = odkryć, odkrywać
discovery = odkrycie
development = rozwój
experiment = doświadczenie, eksperyment
invent = wynaleźć
invention = wynalazek
inventor = wynalazca
laboratory|lab = laboratorium, pracownia
knowledge = wiedza
observe = obserwować, prowadzić obserwacje
results = wyniki badań
research = badania naukowe
science centre = centrum naukowe
scientific = naukowy
scientist = naukowiec
scientific law = prawo naukowe
scientific observations = obserwacje naukowe
study = zbadać
test = próba, analiza
theory = teoria
analyse = analizować, zrobić analizę
analysis = analiza
conclusion = wniosek
connection = związek, połączenie
contain = zawierać
evidence = dowody
experiment on sth|experiment with sth = przeprowadzać doświadczenia, eksperymentować na czymś
reject a hypothesis/an idea|reject a theory/an idea = odrzucić hipotezę / teorię / pomysł
bacteria = bakterie
cancer = rak
gas = gaz
vaccine = szczepionka
vitamin = witamina
cell = komórka
chemical element = pierwiastek chemiczny
chemical reaction = reakcja chemiczna
chemical formula|mathematical formula = wzór, formuła chemiczna / matematyczna
freeze = zamrozić, zamrażać, zamarznąć
germs = bakterie, zarazki
gravity = ciążenie, przyciąganie ziemskie
liquid = ciecz
molecule = cząsteczka, molekuła
oxygen = tlen
prism = pryzmat
scatter light = rozproszyć światło
solid = ciało stałe
steam = para
substance = substancja
theory of relativity = teoria względności
X-ray = promienie Roentgena
blog = blog
CD = płyta CD
chat room = czat
click = kliknąć
double click = kliknąć dwukrotnie
computer = komputer
computer program = program komputerowy
computer programmer = programista, informatyk
cursor = kursor
data = dane
delete = skasować
document = dokument
download a file/ a program|download a data/ a program = ściągać plik / dane / program
email = e-mail
error = błąd
file = plik
flat screen monitor = monitor z płaskim ekranem
folder = katalog
forum|message board = forum internetowe
icon = ikona
information technology = informatyka
the Internet = internet
key = klawisz na klawiaturze
keyboard = klawiatura
laser printer = drukarka laserowa
LCD monitor = monitor ciekłokrystaliczny
link = link
login = login
memory stick|pendrive = pamięć przenośna
mouse = mysz
notebook = komputer przenośny, laptop
online = w sieci
open a file document/an email|open a a document/an email|open a file/a document email|open a file/a an email = otworzyć plik / dokument / e-mail
PC|personal computer = komputer osobisty, stacjonarny
password = hasło
portal = portal internetowy, witryna internetowa
print = drukować
save = zachować, zapisać dokument
screen = ekran
spam = spam
user = użytkownik, użytkowniczka
virus = wirus
website = strona internetowa
at = „małpa" w adresie e-mail
CD-ROM = napęd CD-ROM
DVD drive = napęd DVD
crash = zepsuć się, awaria komputera
database = baza danych
dot = kropka w adresie e-mail
hard disk = twardy dysk
hardware = sprzęt komputerowy
instant messenger = komunikator internetowy
photocopier = kserokopiarka
process = przetwarzać dane
scanner = skaner
search engine = wyszukiwarka internetowa
software = oprogramowanie
speakers = głośniki
USB port = port USB
underscore = podkreślenie w adresie e-mail
wireless = bezprzewodowy
astronaut = astronauta
planet = planeta
rocket = rakieta
space exploration = badanie przestrzeni kosmicznej
space station = stacja kosmiczna
space|outer space = kosmos
comet = kometa
meteor = meteor
satellite = satelita
Solar System = Układ Słoneczny
spacecraft|spaceship = statek kosmiczny
universe = wszechświat
battery = bateria, akumulator
button = przycisk
cable = kabel
digital camera = cyfrowy aparat fotograficzny
electricity = elektryczność, energia elektryczna
machine = maszyna
mobile phone = telefon komórkowy
MP3 player = odtwarzacz MP3
remote control = pilot np. do telewizora
zoom = zoom
adjust = wyregulować
aerial = antena
device = urządzenie
gadget = przyrząd, gadżet
headphones = słuchawki
manual = instrukcja obsługi
plug = wtyczka
socket = gniazdko, kontakt
switch on button = włącznik
switch off button = wyłącznik
technology = technika
break down = zepsuć się
find out = dowiedzieć się, odkryć
press a button = nacisnąć guzik, przycisk
switch on|switch off = włączyć / wyłączyć
surf sites on the Net = surfować po Internecie, przeszukiwać strony w Internecie
turn on|turn off = włączyć / wyłączyć
win the Nobel Prize in ... = zdobyć, dostać nagrodę Nobla w dziedzinie...
area|field|branch of science = dziedzina nauki
carry out an experiment = przeprowadzać doświadczenie, eksperyment
come to the conclusion that... = dojść do wniosku, że...
follow the instructions = postępować zgodnie z instrukcją, poleceniami
field of research = zakres badań
make a discovery = dokonać odkrycia
out of order = zepsuty, nie działa
patent an invention = opatentować wynalazek

[Unit 13 Świat przyrody]
animal = zwierzę
ant = mrówka
bat = nietoperz
bald eagle = bielik amerykański
bear = niedźwiedź
bee = pszczoła
bird = ptak
bull = byk
butterfly = motyl
camel = wielbłąd
chimpanzee = szympans
cow = krowa
crocodile = krokodyl
dolphin = delfin
donkey = osioł
duck = kaczka
eagle = orzeł
elephant = słoń
farm animal = zwierzę domowe
fish = ryba
fly = mucha
fox = lis
frog = żaba
giraffe = żyrafa
goat = koza
gorilla = goryl
horse = koń
insect = owad
kangaroo = kangur
lion = lew
monkey = małpa
mouse = mysz
penguin = pingwin
pig = świnia
polar bear = niedźwiedź polarny
shark = rekin
sheep = owca, owce
snail = ślimak
snake = wąż
tiger = tygrys
whale = wieloryb
wild animals = dzikie zwierzęta
wolf = wilk
zebra = zebra
zoo = ogród zoologiczny
amphibian = płaz
animal species = gatunek, gatunki zwierząt
beaver = bóbr
blue whale = płetwal błękitny
cheetah = gepard
cockroach = karaluch
deer = jeleń
European bison = żubr
giant panda = panda wielka
great ape = małpa człekokształtna
hen = kura
herring = śledź
lamb = jagnię, owieczka
lizard = jaszczurka
mammal = ssak
mosquito = komar
octopus = ośmiornica
owl = sowa
pigeon = gołąb
rat = szczur
reptile = gad
rhino|rhinoceros = nosorożec
salamander = salamandra
salmon = łosoś
squirrel = wiewiórka
squirrel monkey = małpka sajmiri
stork = bocian
toad = ropucha
tortoise = żółw
wildlife = fauna
fur = futro
shell = skorupa, pancerz
tail = ogon
wing = skrzydło
claw = pazur
horn = róg
tusk = kieł
cat = kot
dog = pies
goldfish = złota rybka
hamster = chomik
kitten = kociak, kocię
parrot = papuga
pet = zwierzątko domowe
pet shop = sklep zoologiczny
pony = kucyk
puppy = szczeniak
rabbit = królik
spider = pająk
train a dog cat|train a a cat = tresować psa / kota
bark = szczekać
cage = klatka
feed = karmić
look after = opiekować się
air pollution|water pollution = zanieczyszczenie powietrza / wody
carbon dioxide = dwutlenek węgla
car exhaust fumes = spaliny samochodowe
climate change = zmiana klimatyczna
eco-friendly = przyjazny dla środowiska
emit = emitować, wydzielać
factory = fabryka
generate = wytwarzać
global warming = globalne ocieplenie
greenhouse effect = efekt cieplarniany
harmful substances = szkodliwe substancje
household = gospodarstwo domowe
illegal hunting = kłusownictwo
litter = śmieci, śmiecić
national park = park narodowy
natural environment = środowisko naturalne
poisonous gases = trujące gazy
pollute = zanieczyszczać
recycle = ponownie przetwarzać
recycling bank = pojemnik na odpady
release ... into the atmosphere = emitować ... do atmosfery
renewable energy = energia odnawialna
rubbish bin = pojemnik na śmieci
rubbish = śmieci
save energy|save water = oszczędzać energię / wodę
throw away rubbish = wyrzucać śmieci
waste = odpadki
wind power|solar power = energia wiatru / słoneczna
beach = plaża
coast = wybrzeże, brzeg
desert = pustynia
Earth = Ziemia
field = pole
forest = las
hill = wzgórze, pagórek
island = wyspa
lake = jezioro
landscape = krajobraz
mountain = góra
ocean = ocean
river = rzeka
sand = piasek
sea = morze
valley = dolina
waterfall = wodospad
wave = fala
below sea level|above sea level = poniżej / powyżej poziomu morza
cliff = klif, urwisko
coral reef = rafa koralowa
summit|top = szczyt
surface = powierzchnia
leaf|leaves = liść,liście
plant = roślina
branch = gałąź
root = korzeń
autumn = jesień
central Poland = środkowa Polska
clear sky = czyste niebo
cloud = chmura
cloudy = pochmurny
cold = zimno
dry = suchy
East = wschód
eastern = wschodni
fog = mgła
foggy = mglisty
hot = gorący, gorąco
hurricane = huragan
ice = lód
icy = lodowaty
North = północ
northern = północny
rain = deszcz
rainy = deszczowy
shine = świecić
snow = snow
snowy = śnieżny, ośnieżony
South = południe
southern = południowy
spring = wiosna
storm = burza
stormy = burzowy
summer = lato
sun = słońce
sunny = słoneczny
warm = ciepły, ciepło
weather = pogoda
weather forecast = prognoza pogody
West = zachód
western = zachodni
wet = mokro
wind = wiatr
windy = wietrzny, wietrznie
winter = zima
above zero = powyżej zera
below zero = poniżej zera
blizzard = zamieć, śnieżyca
blow = wiać
chilly = bardzo zimny, bardzo zimno
cool = chłodno
degrees centigrade = stopnie Celsjusza
freezing cold = przenikliwe zimno
frost = mróz
frosty = mroźny, mroźno
heat wave = upał
lightning = błyskawica
melt = topnieć
thunder = grzmot
thunderstorm = burza z piorunami
fire = pożar
avalanche = lawina
destroy = niszczyć
drought = susza
drown = utonąć
earthquake = trzęsienie ziemi
evacuate = ewakuować
famine = głód
flood = powódź
ground = ziemia
hurricane = huragan
lava = lawa
natural disaster = klęska żywiołowa
rescue worker = ratownik
shake = trząść, wstrząs
survivor = ocalały, ocalony (o osobie)
threaten = zagrażać
tsunami = tsunami
victim = ofiara
volcanic eruption = wybuch, erupcja wulkanu
volcano = wulkan
volunteer = ochotnik
in the wild = na wolności
damage the environment|protect the environment = niszczyć / chronić środowisko
drinking water = woda pitna
environmentally friendly = ekologiczny
in danger of extinction = zagrożony wyginięciem
leaded petrol|unleaded petrol = benzyna ołowiowa / bezołowiowa
natural habitat = naturalne środowisko
pick up rubbish = sprzątać śmieci
raise money = zbierać pieniądze

[Unit 14 Życie społeczne]
administrative division = podział administracyjny
anthem = hymn
border = granica, graniczyć z
capital = stolica
citizen = obywatel, obywatelka
country = kraj
emblem = herb
flag = flaga
independence = niepodległość
inhabitant = mieszkaniec, mieszkanka
kingdom = królestwo
monarchy = monarchia
national = narodowy
official language = język urzędowy
population = ludność
province = prowincja, jednostka podziału administracyjnego
republic = republika
state = państwo
voivodeship = województwo
black market = czarny rynek
company = firma
consumer = konsument, konsumentka
currency = waluta
economy = gospodarka
globalisation = globalizacja
industry = przemysł
inflation = inflacja
recession = recesja
tax = podatek
trade = handel
democracy = demokracja
elect = wybierać w wyborach
election = wybory
government = rząd
head of state = głowa państwa
king = król
minister = minister
MP|Member of Parliament = poseł, posłanka
parliament = parlament
party = partia
politician = polityk
politics = polityka
president = prezydent
Prime Minister = premier
queen = królowa
vote = głosować
access to water = dostęp do wody
car accident = wypadek samochodowy
charity work = działalność dobroczynna
civil war = wojna domowa
collect money = zbierać pieniądze
discrimination = dyskryminacja
emigrant = emigrant, emigrantka
emigrate = emigrować
emigration = emigracja
homelessness = bezdomność
immigrant = imigrant, imigrantka
immigrate = imigrować
immigration = imigracja
integrate = integrować się
littering = zaśmiecanie
NGO|non-governmental organisation = organizacja pozarządowa
peace = pokój
poor = biedny
poverty = ubóstwo
racism = rasizm
rich = bogaty
road safety = bezpieczeństwo w ruchu ulicznym
shelter = schronisko
social event = wydarzenie społeczne, towarzyskie
social issues|social problems = zagadnienia / problemy społeczne
society = społeczeństwo
terrorism = terroryzm
traffic = ruch uliczny
traffic jam = korek uliczny
unemployed = bezrobotny
unemployment = bezrobocie
votunteer = wolontariusz, wolontariuszka
alibi = alibi
arrest = aresztować
catch = złapać
crime = przestępczość, przestępstwo
court = sąd
death penalty = kara śmierci
defence = obrona
defendant = pozwany, oskarżony
escape = uciec
evidence = dowody
fine = mandat, grzywna
fingerprint = odcisk palca
guilty = winny
illegal = nielegalny
innocent = niewinny
investigate = prowadzić dochodzenie
investigation = śledztwo, dochodzenie
judge = sędzia
jury = ława przysięgłych
justice = sprawiedliwość
lawyer = prawnik, prawniczka
life imprisonment = dożywotnie więzienie
offence = wykroczenie
penalty = kara, grzywna
police oficer = policjant, policjantka
police station = posterunek policji
prison = więzienie
prison sentence = kara więzienia
private detective = prywatny detektyw
prosecution = oskarżenie, strona oskarżająca
punish = karać
punishment for sth = kara za coś
sentence = wyrok
strict = surowy
trial = proces
witness = świadek
aggression = agresja
armed = uzbrojony
attack sb = zaatakować kogoś
attacker = napastnik, napastniczka
bank robbery = napad rabunkowy na bank
blackmail = szantażować, szantaż
blackmailer = szantażysta, szantażystka
bully = prześladować, znęcać się
bullying = prześladowanie, znęcanie się
burglar = włamywacz, włamywaczka
burglary = kradzież z włamaniem
burgle = włamać się i okraść
criminal = przestępca, przestępczyni
cyberstalking = nękanie w internecie
drug dealer = handlarz narkotykami
drug dealing = handel narkotykami
hijack = porwać, uprowadzić (np. samolot)
hijacker = porywacz, porywaczka (np. samolotu)
hijacking = porwanie, uprowadzenie (np. samolotu)
kidnap = porwać
kidnapper = porywacz, porywaczka
kidnapping = porwanie
kill = zabić
mug = napaść i okraść, popełnić rozbój
mugger = napastnik, napastniczka, sprawca, sprawczyni rozboju
mugging = napad uliczny, rozbój
murder = mordować, morderstwo
murderer = morderca, morderczyni
pick sb's pocket = dokonać kradzieży kieszonkowej
pickpocket = kieszonkowiec
pickpocketing = kradzież kieszonkowa
rob = obrabować
robber = rabuś, bandyta
shoplift = kraść w sklepie
shoplifter = złodziej sklepowy
shoplifting = kradzież sklepowa
stalking = nękanie
steal = kraść
theft = kradzież
thief = złodziej, złodziejka
vandal = wandal
vandalise = dewastować
vandalism = wandalizm
victim = ofiara
violence = przemoc
weapon = broń
accuse sb of = oskarżyć kogoś o
break into = włamać się do
break out = uciec
break the law = łamać prawo
commit a crime = popełnić przestępstwo
discriminate against = dyskryminować
get caught = zostać złapanym
get out of prison = wyjść z więzienia
give up = poddać się
go on trial = mieć proces
present evidence = przedstawić dowody
sentence sb to = skazać kogoś na
solve a mystery = rozwiązać zagadkę

[Unit 15 Elementy wiedzy o krajach anglojęzycznych]
aboriginal = aborygeński
Aborigine = Aborygen, Aborygen ka
Australia = Australia
British = brytyjski
Canada = Kanada
Canadian = kanadyjski, Kanadyjczyk, Kanadyjka
constitution = konstytucja
continent = kontynent
England = Anglia
English = angielski, Anglik, Angielka
Great Britain = Wielka Brytania
Irish = irlandzki, Irlandczyk, Irlandka
island = wyspa
Kiwi = Nowozelandczyk, Nowozelandka (żartobliwie)
New Zealand = Nowa Zelandia
Northern Ireland = Irlandia Północna
Republic of Ireland = Republika Irlandii
royal family = rodzina królewska
Scotland = Szkocja
Scottish = szkocki, Szkot, Szkotka
South Africa = Republika Południowej Afryki
state = stan USA
United Kingdom = Zjednoczone Królestwo
USA = Stany Zjednoczone
Wales = Walia
Welsh = walijski, Walijczyk, Walijka
British Isles = Wyspy Brytyjskie
the Commonwealth = Wspólnota Narodów
pound sterling = funt szterling
Ulster = Irlandia Północna
Ayers Rock|Uluru = monolit skalny w Australii
Big Ben = słynna wieża zegarowa i zegar w Londynie
Buckingham Palace = Pałac Buckingham, oficjalna rezydencja królów angielskich
castle = zamek
clock tower = wieża zegarowa
the Empire State Building = wieżowiec w Nowym Jorku
Eton College = jedna z najstarszych w Anglii męskich szkół z internatem
the Grand Canyon = Wielki Kanion
the Houses of Parliament = budynki parlamentu brytyjskiego w Londynie
the Niagara Falls = wodospad Niagara
the Statue of Liberty = Statua Wolności, posąg w Nowym Jorku
the Tower of London = historyczna budowla obronna i pałacowa w Londynie
10, Downing Street = adres rezydencji i biura premiera Wielkiej Brytanii oraz siedziba rządu
Alaska = Alaska, stan w północno-zachodniej części USA
Baker Street = ulica w Londynie, znana dzięki literackiej postaci Sherlocka Holmesa
Ben Nevis = najwyższy szczyt Wysp Brytyjskich, położony w Szkocji
Cambridge = drugi po Oksfordzie najstarszy uniwersytet w Anglii
Disneyworld = największy na świecie park rozrywki
Florida = Floryda
Harvard = Uniwersytet Harvarda, najstarsza instytucja edukacyjna w USA
Hawaii = Hawaje
Loch Ness Monster = potwór z Loch Ness
Madame Tussauds = Muzeum Figur Woskowych Madame Tussaud w Londynie
Oxford = Oksford, najstarszy uniwersytet w krajach anglojęzycznych
Sherlock Holmes = detektyw, bohater powieści i opowiadań kryminalnych Artura Conan Doyle'a
Stonehenge = słynna budowla megalityczna w południowej Anglii
wax model = figura woskowa
the White House = Biały Dom, oficjalna rezydencja i biuro prezydentów USA
Elizabeth I = Elżbieta I, królowa Anglii i Irlandii w latach 1558-1603
George Washington = pierwszy prezydent USA w latach 1789-1797
Nelson Mandela = prezydent RPA w latach 1994-1999, laureat Pokojowej Nagrody Nobla
William Shakespeare = William Szekspir, wybitny angielski dramaturg, poeta i aktor
Buzz Aldrin = astronauta amerykański, brał udział w pierwszym lądowaniu na Księżycu
Christopher Columbus = Krzysztof Kolumb, odkrywca, żeglarz
Lech Wałęsa = pierwszy przewodniczący „Solidarności", laureat Pokojowej Nagrody Nobla
Michael Collins = astronauta amerykański, brał udział w pierwszym lądowaniu na Księżycu
Neil Armstrong = astronauta amerykański, pierwszy człowiek na Księżycu
Pope John Paul II = Papież Jan Paweł II
Stanislaus Augustus = Stanisław August, ostatni król Polski
William the Conqueror = Wilhelm Zdobywca, dowódca Normanów podczas inwazji na Anglię
the Battle of Hastings = Bitwa pod Hastings, decydujące starcie w inwazji Normanów na Anglię w 1066 roku
the Constitution of May 3 = Konstytucja 3 Maja, pierwsza nowoczesna konstytucja w Europie i druga na świecie, uchwalona w Polsce w 1791
roku the discovery of America = odkrycie Ameryki
Moon landing = lądowanie na Księżycu
Nobel Peace Prize = Pokojowa Nagroda Nobla
April Fools' Day = Prima Aprilis
Auld Lang Syne = tradycyjna szkocka pieśń
barbecue = przyjęcie przy grillu
Christmas cracker = tradycyjny angielski bożonarodzeniowy cukierek
custom = zwyczaj
Guy Fawkes' Night = noc Guya Fawkesa, angielskie święto ludowe obchodzone 5 listopada w rocznicę spisku Guya Fawkesa
haggis = potrawa kuchni szkockiej
Halloween = święto duchów i zmarłych, obchodzone w krajach anglosaskich w noc 31 października
Hogmanay = tradycyjne szkockie obchody wieczoru sylwestrowego
Independence Day = Dzień Niepodległości Stanów Zjednoczonych, obchodzony 4 lipca
let off fireworks = odpalać sztuczne ognie
maple syrup = syrop klonowy
national holiday = święto narodowe
parade = parada
play tricks = robić psikusy
St Patrick's Day = Dzień Świętego Patryka (patrona Irlandii)
step dancing = step irlandzki
Thanksgiving = Święto Dziękczynienia
Valentine's Day = walentynki, święto zakochanych
bagpipes = dudy, instrument dęty popularny m.in. w Szkocji i Irlandii
cricket = krykiet
hospitality = gościnność
kilt = kilt, szkocka spódnica w kratę, narodowy strój szkocki
tartan = tartan klanowy, tkanina wełniana o kraciastym wzorze
apartment (AmE) = mieszkanie
biscuit (BrE) = ciasteczko
candy (AmE) = cukierki
car park(BrE) = parking
chips (AmE) = chipsy
chips (BrE) = frytki
cinema (BrE) = kino
cookie (AmE) = ciasteczko
elevator (AmE) = winda
eraser (AmE) = gumka
the first floor (AmE) = parter
flat (BrE) = mieszkanie
French fries (AmE) = frytki
garbage (AmE) = śmieci
gas|gasoline (AmE) = benzyna
ground floor (BrE) = parter
holiday (BrE) = wakacje
lift (BrE) = winda
line (AmE) = kolejka
movie theater (AmE) = kino
parking lot (AmE) = parking
petrol (BrE) = benzyna
public school (AmE) = szkoła państwowa
public school (BrE) = szkoła prywatna
queue (BrE) = kolejka
rubber (BrE) = gumka
rubbish (BrE) = śmieci
sneakers (AmE) = buty sportowe
subway (AmE) = metro
sweets (BrE) = cukierki
underground|tube (BrE) = metro
vacation (AmE) = wakacje
ambassador = ambasador
class exchange = wymiana klasowa
collaborate = współpracować
Comenius = Comenius, program edukacyjny Unii Europejskiej, część programu
Sokrates eTwinning = eTwinning, program unijny mający na celu pomoc w realizacji projektów szkolnych przy pomocy technologii informacyjno--komunikacyjnych
the European Union = Unia Europejska
exchange programme = program wymiany młodzieży
host family = rodzina goszcząca
mobility = mobilność
online cooperation = współpraca w Internecie
Rotary Youth Exchange = Międzynarodowy Program Wymiany Młodzieży Rotary Youth Exchange
