[Longman - rozszerzony]

[Unit 1 Człowiek]
date of birth=data urodzenia
citizenship=obywatelstwo
gender|sex=płeć
given name|first name=imię
family name=nazwisko
male|female=płeć męska, żeńska
marital status=stan cywilny
middle name=drugie imię
occupation=zawód
racial/ethnic group=grupa etniczna
spouse=współmałżonek 
muscular=muskularny
obese=otyły
overweight=z nadwagą
plump=pulchny
skinny|thin=chudy
slender|slim=szczupły
stocky=krępy 
curly=kręcone
fringe=grzywka
frizzy=kędzierzawe
highlights=pasemka
plait=warkocz
ponytail=kucyk
tied in a bun=zebrane w kok 
dimple=dołek
freckles=piegi
mole|beauty spot=pieprzyk
piercing=kolczyk
scar=blizna
tattoo=tatuaż
wrinkles=zmarszczki 
cape=peleryna
cape cardigan=luźny, rozpinany sweter
dressing gown=szlafrok
hoodie=bluza z kapturem
jersey=sweter, koszulka sportowa
sleeve=rękaw
sweatshirt=bluza 
bracelet=bransoletka
high heels=buty na wysokim obcasie
motorcycle boots=buty motocyklowe
necklace=naszyjnik
scarf=szalik, apaszka
slippers=kapcie
tie=krawat 
fold=złożyć
shrink=skurczyć się
stretch=rozciągnąć się
undo the buttons=rozpiąć guziki
untie the shoes=rozwiązać buty 
baggy=workowaty
casual=nieformalny 
creased=wygnieciony
faded=wypłowiały
feminine=kobiecy
floaty=zwiewny
floral=w kwiaty
flowy=spływający swobodnie
loose|loose-fitting=luźny
ripped=podarty, z dziurami
scruffy=niechlujny
shabby=zaniedbany
sleeveless=bez rękawów
smart/elegant=elegancki
stretchy=rozciągliwy, elastyczny
striped=w paski
stylish=stylowy
tight|tight-fitting=ciasny
trendy=modny
unique=unikalny
vintage=staromodny (jako zaleta) 
blend into the crowd=wmieszać się w tłum
conform to a style=dopasować się do stylu
express sb's individuality=być wyrazem czyjejś indywidualności
switch allegiance=zmienić przynależność 
glance=rzucić okiem
glare=wpatrywać się ze złością
glimpse=spojrzeć przelotnie
inspect|scrutinise=zlustrować
peek=zerkać
peer=przyglądać się
stare=gapić się, wpatrywać się
watch=obserwować 
hiss=syczeć
moan=jęczeć, narzekać
mumble|mutter=mamrotać
shout=krzyczeć
stutter=jąkać się
whisper= szeptać komuś do ucha
yell=wrzeszczeć 
bang your fist=uderzyć pięścią
cross your legs=skrzyżować nogi
fold your arms across your chest=skrzyżować ramiona na piersi
frown=zmarszczyć brwi
gesture=gest
hands on hips=ręce na biodrach
have your elbows on the table=opierać się łokciami o stół
hide your face in your hands=ukryć twarz w dłoniach
hug=objąć
lean back=odchylać się, opierać się, rozpierać się na krześle
posture=postawa
purse your lips=zacisnąć usta
raise your eyebrows=unieść brwi ze zdumienia
shake your head=potrząsnąć głową
shrug your shoulders=wzruszyć ramionami
stand with your feet apart=stać na szeroko rozstawionych nogach
tap your fingers on a table=bębnić palcami w stół 
tremble=drżeć, trząść się
turn to sb=odwrócić się do kogoś
wink=mrugnąć 
absent-minded=roztargniony
argumentative=kłótliwy
arrogant=arogancki
bossy=dominujący, apodyktyczny
bright=bystry, rozgarnięty
broad-minded=o szerokich horyzontach
busybody=osoba wścibska
caring=troskliwy
conceited=zarozumiały
conscientious=sumienny
cynical=cyniczny
dishonest=nieuczciwy
disIoyal=nielojalny
disorganised=niezorganizowany
dull=nudny
entertaining=zabawny, wesoły
flexible=elastyczny
generous=hojny
gullible=łatwowierny
humbie=skromny
immature=niedojrzały
immodest=nieskromny
impatient=niecierpliwy
imperfect=niedoskonały
impoiite=nieuprzejmy
indiscreet=niedyskretny
inefficient=niesprawny, niewydajny, nieskuteczny
insensitive=niewrażliwy
insincere=nieszczery
intolerant=nietolerancyjny
irrational=nieracjonalny
irresponsible=nieodpowiedzialny
mean=skąpy, złośliwy
messy=nieporządny
narrow-minded=o wąskich horyzontach
nosy=wścibski
over-ambitious=zbyt ambitny
partial=stronniczy
impartial=bezstronny
perfectionist=perfekcjonista
procrastinator=osoba, która wszystko odkłada na później
rebeliious=buntowniczy
reserved=powściągliwy
romantic=romantyczny
 rude=nieuprzejmy
sef-centred=egocentryczny
self-confident|self-assured=pewny siebie
self-conscious=nieśmiały, skrępowany
sensible|reasonable=rozsądny
shy=nieśmiały
strict=surowy
stubborn=uparty
stupid=głupi
suspicious=podejrzliwy
sympathetic= współczujący
talkative=gadatliwy
trustworthy=godny zaufania
unimaginative=nieobdarzony wyobraźnią
unintelligent=nieinteligentny 
unpunctual=niepunktualny
unreasonable=nierozsądny
unreliable=nierzetelny, niesumienny
unscrupulous=pozbawiony skrupułów
vain=próżny 
affection=uczucie, sympatia
angry=zły
annoy=drażnić, irytować
anxiety=niepokój
anxious=niespokojny
apprehensive=pełen obaw
ashamed=zawstydzony
astonished=zdziwiony
bewildered=skonsternowany, oszołomiony
confused=zdezorientowany
depressed=przygnębiony, smutny
devastated=zdruzgotany
elated=uszczęśliwiony
embarrassed=zażenowany, zawstydzony
excited=podekscytowany
exhausted=wyczerpany
frightened=przestraszony
frustrated=sfrustrowany
furious=wściekły
gloomy=ponury
heartbroken=zrozpaczony, załamany
in a bad temper=zirytowany
in the mood for sth=w nastroju na coś
indifferent to=obojętny na
long for sb/sth=tęsknić za kimś/czymś
lose your temper=stracić panowanie nad sobą
miserabie=nieszczęśliwy
moved=wzruszony
nervous=zdenerwowany
overwhelmed=przytłoczony
respect=szanować
stressed out=zestresowany
surprised=zaskoczony
terrified|petrified=przerażony
thrilled=bardzo podekscytowany
tired=zmęczony
unhappy=nieszczęśliwy 
be down in the dumps=mieć chandrę, być bardzo smutnym
be over the moon=nie posiadać się ze szczęścia
get butterflies in your stomach=mieć tremę
wake up in a cold sweat=obudzić się zlanym zimnym potem 
adjust to=dostosować się do
admire=podziwiać
approve of sth=aprobować coś
attitude=postawa, nastawienie
be passionate about sth=pasjonować się czymś
belief=pogląd, przekonanie
content with=zadowolony z
convinced of=przekonany o
disapprove of=nie aprobować czegoś
dismiss=odrzucić
dismissive=lekceważący
focused on=skupiony, skoncentrowany na
have a go at sth=spróbować coś zrobić
indifferent to=obojętny na
insist on=nalegać na
regard sth as=uważać coś za
take an interest in sth=zainteresować się czymś
take pride in sth=szczycić się czymś 
assume=zakładać
assumption=założenie, przypuszczenie
change your mind=zmienić zdanie
come to sb's mind=przyjść komuś na myśl
compliment sb on sth=gratulować komuś czegoś
confront sth=stawiać czemuś czoło
deal with sth=radzić sobie z czymś
distract=rozpraszać
gain sb's confidence=zyskać czyjeś zaufanie
get your head around sth=zzumieć i zaakceptować coś
go to one's head=uderzyć do głowy
have a good head for sth=mieć głowę do czegoś
have sth on your mind=stale myśleć o czymś
imagine=wyobrazić sobie
lose your head=stracić głowę
lose your mind=stracić zmysły, oszaleć
make up your mind=zdecydować się
multitask=zajmować się kilkoma rzeczami naraz, mieć podzielną uwagę
off the top of your head=bez zastanowienia
perceive=postrzegać, dostrzegać
perception=postrzeganie
realise=uświadomić sobie
recall|recollect=przypomnieć sobie
regard sth as=uważać coś za
sense=zmysł 
abortion=aborcja
animal testing=testowanie na zwierzętach
cloning=klonowanie
death penalty|capital punishment=kara śmierci
ethical dilemma=dylemat etyczny
euthanasia=eutanazja
genetic engineering=inżynieria genetyczna
GMO|genetically modified organism=organizm zmodyfikowany genetycznie
IVF|in vitro fertilisation=zapłodnienie in vitro
marijuana legalisation=legalizacja marihuany
organ donation=dawstwo organów
same-sex|gay marriage=małżeństwo homoseksualne 

[Unit 2 Dom]
basement flat=mieszkanie w suterenie
bedsit=wynajęty pokój, kawalerka
bungalow=dom parterowy, bungalow
chalet=domek letniskowy
converted loft=zaadaptowane poddasze
cottage=dom na wsi
country house=okazały dom na wsi, dwór
detached house=dom wolno stojący
farmhouse=dom wiejski
high-rise block/building=wieżowiec
holiday home=dom letni/ wakacyjny
manor=dwór
mansion=rezydencja
motor home=samochód kempingowy
penthouse=luksusowy apartament na ostatnim piętrze budynku
pre-war building=budynek przedwojenny
semi-detached house=dom bliźniak
skyscraper=drapacz chmur
stately home=zabytkowa rezydencja wiejska, dwór, pałac
studio flat|apartment=kawalerka
terraced house|terrace=dom szeregowy
townhouse=kamienica
two-storey building=budynek dwupiętrowy 
backyard=podwórko za domem, ogródek za domem
boathouse=hangar dla łodzi
chimney=komin
climbing frame=drabinka
conservatory=oranżeria, szklarnia
double garage=garaż na dwa samochody
drive|driveway=podjazd
facade=fasada
fence=ogrodzenie
flowerbed=grządka
French windows=w całości przeszklone drzwi
garden chairs=krzesła ogrodowe
gutter|drainpipe=rynna
gravel=żwir
hedge=żywopłot
lawn=trawnik
letter box=skrzynka na listy
outhouse=przybudówka
path=ścieżka
patio furniture=meble ogrodowe
plot of land=działka
porch=ganek
railing=ogrodzenie metalowe
roof tiles=dachówki
sandbox=piaskownica
shed=składzik, schowek
shutters=okiennice
skylight=świetlik w dachu
sprinkler=zraszacz 
steps=schodki
streetlight|streetlamp=latarnia uliczna
swing=huśtawka
terrace=taras
well=studnia 
air conditioning=klimatyzacja
banister=poręcz, balustrada
bath|bathtub=wanna
bathroom tiles=płytki łazienkowe
bedding= pościel
bedside table|night table=stolik nocny
birdcage=klatka dla ptaków
blanket=koc 
bookshelf|bookshelves =półka,półki na książki
brass handle=mosiężna klamka
built-in wardrobe=szafa wnękowa
bunk beds=łóżko piętrowe
burglar alarm=alarm antywłamaniowy
candlestick=świecznik
ceiling=sufit
chest of drawers=komoda
cot|crib=łóżeczko dziecięce
cradle=kołyska
curtains=zasłony
cushion=poduszka dekoracyjna
desk=biurko
dressing table=toaletka
doorbell=dzwonek do drzwi
doorknob=gałka u drzwi
doormat=wycieraczka
double glazing=podwójne szyby w oknach
dryer=suszarka
fireplace=kominek
fitted/wall-to-wall carpet=wykładzina dywanowa
framed photograph=zdjęcie oprawione w ramkę
glass-fronted bookcase=przeszklony regał na książki, biblioteczka
glass-fronted cabinet=przeszklona serwantka
grandfather clock=zegar szafkowy
high chair=wysokie krzesełko dla dziecka
hot water heater|cylinder=bojler
household appliances=sprzęt AGD
jacuzzi=jacuzzi
king-sized bed=szerokie łóżko
kitchen sink=zlew kuchenny
knick-knack=bibelot
landing=półpiętro
light fixtures=oświetlenie, instalacja oświetleniowa
made to order=robiony na zamówienie
mantelpiece=półka nad kominkiem
marble worktop=marmurowy blat kuchenny
mattress=materac
 office/swivel chair=obrotowe krzesło biurowe
oil-fired central heating=centralne ogrzewanie olejowe
ornament=ozdoba
parquet=parkiet
Persian rug=perski dywan
pillow=poduszka do spania
pillowcase=poszewka na poduszkę
playpen=kojec dla dziecka
plumbing=instalacja wodno-kanalizacyjna
potted plant=roślina doniczkowa
quilt|duvet=kołdra
radiator=grzejnik, kaloryfer
rocking chair=fotel bujany
roller blinds=rolety
rug=dywanik
running water= woda bieżąca
satellite dish=antena satelitarna
shower curtain=zasłonka prysznicowa
sofa bed=rozkładana kanapa
stool=taboret, stołek
toilet=sedes
toilet seat=deska sedesowa
upholstered chair=krzesło tapicerowane
Venetian blinds=żaluzje
wallpaper=tapeta
washbasin=umywalka
washing machine=pralka
windowsill=parapet 
airy|spacious=przestronny
arty=artystyczny, wysmakowany
bare=pusty
bright=jasny
cluttered=zagracony
cosy=przytulny
cramped=ciasny, zastawiony
damp=wilgotny
designed by=zaprojektowany przez
dilapidated=w opłakanym stanie
dingy=obskurny
draughty=z przeciągami
easy-to-clean=łatwy do czyszczenia
en suite=z łazienką
fully equipped/fitted=w pełni wyposażony
impressive=robiący wrażenie, imponujący
messy=niechlujny, zabałaganiony, nieporządny
neat and tidy=schludny, czysty
open-plan=otwarty, bez ścianek działowych
quaint=uroczy, o staroświeckim wdzięku
run-down=zniszczony
shabby=zaniedbany
soundproof=dźwiękoszczelny, wyciszony
sparsely decorated=skąpo urządzony/umeblowany
stylish=stylowy, elegancki
sunny=słoneczny
ultra-modern=ultranowoczesny
welcoming=przyjemny, przytulny 
commute=dojeżdżać codziennie do pracy lub szkoły 
conveniently/pleasantly located=wygodnie/ ładnie usytuowany
countryside=wieś
district=dzielnica
downtown=śródmiejski, centralny
downtown=śródmieście, centrum
fenced off=ogrodzony
gated community=ogrodzone osiedle mieszkaniowe
green areas=tereny zielone
housing estate=osiedle mieszkaniowe
hustle and bustle=zgiełk
inhabitant|resident=mieszkaniec
isolated=odizolowany
leafy=pełen zieleni
location=położenie
outskirts=peryferie miasta
pedestrian precinct=obszar wydzielony dla ruchu pieszego
playground=plac zabaw, boisko
residential area=dzielnica mieszkaniowa
suburb=przedmieście
suburban=podmiejski
trailer park=osiedle przyczep kempingowych
within easy reach of=w pobliżu czegoś
within walking distance of=niewielkiej, możliwej do pokonania piechotą odległości od czegoś
accommodation=zakwaterowanie
affordable housing=mieszkania, lokale w rozsądnej cenie
deposit=kaucja
estate agent=agent sprzedaży nieruchomości, pośrednik
evict=eksmitować
eviction=eksmisja
for sale=na sprzedaż
householder=właściciel domu, mieszkania
keep up the repayments=być na bieżąco ze spłatą rat
landlord|landlady=właściciel/właścicielka wynajmowanego domu
lease=wynajmować, dzierżawić, najem, dzierżawa
mortgage=hipoteka, kredyt hipoteczny
non-payment of the mortgage=brak spłaty kredytu
real estate|property=nieruchomość
rent=wynająć; czynsz
repossess=przejąć na własność
tenancy=najem, dzierżawa
tenant=lokator, lokatorka
to let=do wynajęcia 
broken|out of order=zepsuty
connect electricity=podłączyć prąd
construction site=plac budowy
dismantle=demontować, rozkładać na części 
DIY=majsterkowanie
dust the furniture=ścierać kurze z mebli
fasten=przymocować 
fix|repair|mend=naprawić
household repairs=naprawy domowe
install=instalować, montować
insulate the attic=docieplić poddasze
length=długość
height=wyskość
width=szerokość
weight=waga
maintenance=konserwacja, utrzymanie
mend a dripping tap=naprawić cieknący kran
mow the lawn=kosić trawnik
oil the hinges=naoliwić zawiasy
paint sth blask=pomalować coś na czarno
paper the walls=tapetować ściany
redecorate|refurbish=remontować, odnawiać
redecoration|refurbishment=remont
replace=wymieniać
scaffolding=rusztowanie
strength=siła, wytrzymałość
sweep/vacuum the floor=zamieść/odkurzyć podłogę
tighten a screw=dokręcić śrubę
tile=kafelek
tile the walls=wykafelkować ściany
under construction=w budowie
unscrew=odkręcić śrubę
varnish=polakierować
wipe=wytrzeć, przetrzeć 
clean up the mess=posprzątać bałagan
come off the walls=odchodzić od ścian
do up a flat=odnowić mieszkanie
drop in on sb=wpaść do kogoś
let out a flat=wynająć komuś mieszkanie
 move in/out=wprowadzić się/wyprowadzić się
put in bathroom fittings=zainstalować wyposażenie łazienki
put up shelves=wieszać półki
see to sth=zająć się czymś, dopilnować czegoś
switch on/off=włączać/wyłączać
take out a bank loan=wziąć pożyczkę bankową 
throw out rubbish=wyrzucać śmieci 
a real home from home=miejsce, gdzie człowiek czuje się jak w domu
collapse like a house of cards=zawalić się jak domek z kart
eat sb out of house and home=objeść kogoś, wyczyścić komuś lodówkę
feel at home=czuć się swobodnie
get on like a house on fire=z miejsca się zaprzyjaźnić
keep house=prowadzić dom
make yourself at home=czuć się jak u siebie w domu
move house=przeprowadzać się
open house=dom otwarty
set up house/home=założyć własny dom
There is no place like home=Nie ma jak w domu
till the cows come home=bez końca

[Unit 3 Szkoła]
boarding school=szkoła z internatem
college=szkoła pomaturalna, kolegium,uniwersytet
independent school=szkoła niepubliczna
nursery school|kindergarten=przedszkole
primary school=szkoła podstawowa
public school|private school=szkoła prywatna
secondary school|junior high school| middle school|senior high school=gimnazjum, szkoła średnia 
state school|public school=szkoła publiczna
vocational school=szkoła zawodowa 
academic year=rok akademicki
apply to university=ubiegać się o przyjęcie na uniwersytet
attend lectures=uczęszczać na wykłady
BA dissertation=praca licencjacka
BA|Bachelor of Arts=licencjat w dziedzinie nauk humanistycznych
BEd|Bachelor of Education=licencjat w dziedzinie pedagogiki
BSc|Bachelor of Science=licencjat w dziedzinie nauk ścisłych
campus=kampus uniwersytecki
dean=dziekan
do/get a degree=uzyskać stopień naukowy
dorm|halls=akademik
get a scholarship/grant=dostać stypendium
get into university=dostać się na uniwersytet
graduate=absolwent
graduate=ukończyć studia
lecturer=wykładowca
MA|Master of Arts=magister w dziedzinie nauk humanistycznych
MEd|Master of Education=magister w dziedzinie pedagogiki
MSc|Master of Science=magister w dziedzinie nauk ścisłych
PhD|Doctor of Philosophy=doktor, doktorat
postgraduate course=studia magisterskie po licencjacie lub podyplomowe
research paper=publikacja naukowa
sabbatical leave=urlop naukowy
seminar=seminarium naukowe
term paper=praca semestralna
thesis=praca magisterska, doktorska 
tuition|university fees=czesne
tutorial=konsultacje, seminarium
undergraduate=student, studentka pierwszych trzech lat przed uzyskaniem licencjatu 
workshop=warsztaty, zajęcia praktyczne 
Humanities=nauki humanistyczne
Law=prawo
Linguistics=językoznawstwo
Psychology=psychologia
Social Sciences=nauki społeczne
Sociology=socjologia 
certificate=certyfikat, świadectwo
compulsory=obowiązkowy
deputy head|assistant principal=wicedyrektor, wicedyrektorka
enrol on a course=zapisać się na kurs
extra-curricular activities=zajęcia dodatkowe, zajęcia pozalekcyjne
follow the curriculum=realizować program nauczania
form teacher=wychowawca, wychowawczyni
head teacher|principal|headmaster| headmistress=dyrektor, dyrektorka
mixed-ability class=klasa złożona z uczniów o różnym poziomie umiejętności
optional=nieobowiązkowy
schoolchild=uczeń, uczennica
school fees=czesne
school year=rok szkolny
state education=szkolnictwo publiczne
syllabus|curriculum=program nauczania
teaching staff=grono pedagogiczne
term=semestr
timetable=plan lekcji 
backpack=plecak
compass|compasses=cyrkiel
file|ring binder=segregator
folder=teczka
fountain pen=pióro wieczne
highlighter=zakreślacz
hole punch=dziurkacz
notepad=notatnik
notebook|exercise book=zeszyt
paperclip=spinacz do papieru
pencil sharpener=temperówka
rubber=gumka
ruler=linijka
set square=ekierka
stapler=zszywacz
whiteboard=tablica biała
whiteboard marker=pisak do tablic 
analyse=analizować 
Chemistry=chemia
Economics=ekonomia
English Literature=język angielski, literatura angielska
essay=wypracowanie
Geography=geografia
graph=wykres
History=historia
interpretation=interpretacja
Maths=matematyka
paper|electronic textbook=podręcznik w wersji papierowej/elektronicznej
run/carry out experiments=przeprowadzać eksperymenty
Science=przedmioty ścisłe, przyrodnicze
solve quadratic equations=rozwiązywać równania kwadratowe
source texts=teksty źródłowe
take notes=robić notatki
test tube=probówka
write up an experiment=opisać doświadczenie 
abilities=zdolności
academic results/achievements=wyniki w nauce
academic standards=poziom nauczania
all-round development=wszechstronny rozwój
attend school=chodzić do szkoły
average=przeciętny
bookworm=mól książkowy
brainstorm=przeprowadzać burzę mózgów, dyskutować
creativity=kreatywność
distinguished=wybitny, znakomity
excel at sth=celować w czymś
gifted|talented=uzdolniony
give feedback on|go over|discuss/homework=omawiać pracę domową
homeschooling=nauczanie domowe
know-it-all=mądrala
learning difficulties=trudności w uczeniu się
make progress=robić postępy
memorise|learn by heart=uczyć się na pamięć
outstanding grades=znakomite oceny
pay attention to=uważać, słuchać uważnie
set targets=wyznaczać cele
skills=umiejętności
swot=kujon
take the register|take attendance=sprawdzać listę obecności
teamwork=praca zespołowa 
ADHD|Attention-Deficit Hyperactivity Disorder=ADHD, zespół nadpobudliwości psychoruchowej z deficytem uwagi
be off school=nie chodzić do szkoły
bully=prześladować w szkole
bully=prześladowca
bullying=prześladowanie
CCTV camera=kamera monitoringu
cheat=oszukiwać, ściągać
copy from sb=ściągać, spisywać od kogoś
crib notes|cheat notes=ściągi
do well/badly at school=mieć dobre/złe wyniki w szkole
do well/badly in exams=mieć dobre/złe wyniki na egzaminach
dyslexia=dysleksja
dyslexic=dyslektyczny
expel sb/throw sb out from school=wydalić kogoś ze szkoły
expulsion=wydalenie
fail to achieve sth=nie osiągnąć czegoś
failure=porażka, niepowodzenie
get poor results=mieć słabe wyniki
have a hard time=mieć problemy,trudności
hopeless at Maths=beznadziejny z matematyki
individual approach=indywidualne podejście
misbehave=źle się zachowywać
offence=przewinienie
overcome problems=pokonywać problemy
remedial classes=zajęcia wyrównawcze
skip Iessons/classes/school =chodzić na wagary
special educational needs=specjalne potrzeby edukacyjne
support=wsparcie
weaker areas=słabe punkty 
A-levels=brytyjski odpowiednik matury
assessment=ocena, ocenianie
entrance exam=egzamin wstępny
exam paper=arkusz egzaminacyjny
exam results=wyniki egzaminu
examination rules=zasady zdawania egzaminu
external/internal exam=egzamin zewnętrzny/wewnętrzny
fail a test/an exam=niezdać testu/egzaminu
flunk an exam=oblać egzamin
GCSEs=brytyjski odpowiednik egzaminu gimnazjalnego
grade=stopień, ocena
grade point average=średnia ocen 
mark=ocena, stopień wyrażony w punktach
mark=sprawdzać, oceniać
mock exam=egzamin próbny
online report=dzienniczek internetowy
pass a test/an exam=zdać test/egzamin
past papers=arkusze egzaminacyjne z poprzednich lat
resit/retake an exam=zdawać egzamin ponownie
school-leaving exam=egzamin po ukończeniu nauki w szkole
school report=świadectwo szkolne
score/get 100 points=otrzymać sto punktów
set an exam=przygotować egzamin
sit/take an exam=podejść do egzaminu
take a test=pisać sprawdzian 
afterschool club=świetlica szkolna
attend a course=chodzić na kurs
be/become a member=być/zostać członkiem
develop artistically=rozwijać zdolności artystyczne
develop Ieadership/interpersonal skills=rozwijać umiejętności przywódcze/interpersonalne
first aid training=kurs pierwszej pomocy
join a club/the gym=zapisać się do klubu/na siłownię
participate in=brać udział w
school choir=chór szkolny
school orchestra=orkiestra szkolna
society=towarzystwo, stowarzyszenie
sports/drama/chess/photography club=kółko sportowe/teatralne/szachowe/fotograficzne
voluntary=dobrowolny 
be off school=być nieobecnym w szkole
catch up on school work=nadrobić materiał z zajęć
catch up with the rest of the class=dogonić resztę klasy
drop out of school=rzucić szkołę
fall behind with school work=mieć zaległości w nauce
get down to work=zabrać się do pracy
hand in homework/an essay=oddać pracę domową / wypracowanie
note down=zapisać, zanotować
take in information=przyswajać informacje
turn up late=spóźnić się 
a piece of cake=łatwizna, pestka
burn the midnight oil=pracować do późna w nocy
feel out of your depth=całkowicie się pogubić
know sth inside out=znać coś na wylot
pass an exam with flying=colours zdać egzamin śpiewająco 

[Unit 4 Praca]
accountant=księgowy,księgowa
art restorer=konserwator dzieł sztuki
babysitter=opiekunka do dziecka
bank cashier=kasjer, kasjerka w banku
barrister=adwokat
beautician=kosmetyczka
civil servant=urzędnik państwowy
composer=kompozytor
construction worker=robotnik budowlany
counsellor=psycholog, psycholożka
customer service advisor=pracownik działu obsługi klienta
dustman|refuse collector=śmieciarz
fashion designer=projektant, projektantka mody
fitness instructor=instruktor, instruktorka fitnessu
flight attendant=steward, stewardesa
graphic designer=grafik
insurance agent=agent ubezpieczeniowy
interior designer=projektant, projektantka wnętrz
interpreter=tłumacz ustny
museum curator=kustosz, kustoszka
nurse=pielęgniarz, pielęgniarka
plumber=hydraulik
receptionist=recepcjonista, recepcjonistka
sales rep/representative=przedstawiciel handlowy, przedstawicielka handlowa
software designer=programista
stockbroker=makler giełdowy
traffic warden=kontroler, kontrolerka opłat parkingowych
translator=tłumacz pisemny
travel agent=agent, agentka biura podróży
truck driver=kierowca ciężarówki
 web/website designer=projektant stron internetowych 
badly-paid=słabo płatny
blue-collar=fizyczny
caring=związany z opieką
challenging=wymagający, stanowiący wyzwanie
creative=twórczy
demanding=wymagający
full-time=na pełny etat
high-powered=odpowiedzialny, ważny
lucrative=lukratywny, dobrze płatny
manual=fizyczny
menial=niewymagający kwalifikacji
part-time=na niepełny etat
permanent=stały
profitable=przynoszący wysokie dochody
repetitive=monotonny
rewarding=satysfakcjonujący
temporary=tymczasowy
voluntary=charytatywny, w wolontariacie
well-paid=dobrze płatny
white-collar=umysłowy, urzędniczy 
Accounts=dział księgowości
Customer Service=dział obsługi klienta
Human Resources=dział kadr
Marketing=dział marketingu
Public Relations=dział zajmujący się kreowaniem wizerunku firmy
Research &  Development=dział badawczo-rozwojowy
Sales=dział sprzedaży 
apprentice=czeladnik
boss=szef, szefowa 
CEO, Chief Executive Officer=dyrektor zarządzający
 co-worker=współpracownik, współpracowniczka
colleague=kolega, koleżanka z pracy
Finance Director=dyrektor finansowy
intern=stażysta
interviewer=osoba przeprowadzająca rozmowę kwalifikacyjną
line manager=bezpośredni przełożony
management=zarząd
Managing Director=dyrektor zarządzający
PA|Personal Assistant=asystent, asystentka
recruiter=osoba rekrutująca pracowników
staff=personel
subordinate=podwładny
superior=zwierzchnik, przełożony
trainee=osoba w trakcie szkolenia
volunteer=wolontariusz, wolontariuszka
workaholic=pracoholik, pracoholiczka 
annual bonus=premia roczna
annual income=roczny dochód
back pay=zaległa wypłata
child benefit=zasiłek na dziecko
commission=prowizja
earn=zarabiać
interest=odsetki
on the dole=na zasiłku
pay=płaca
pay rise=podwyżka
pension=emerytura, renta
pension plan=plan emerytalny
profit=zysk
salary slip=pasek wynagrodzenia
shares=udziały, akcje
starting salary=pensja początkowa
tip=napiwek
unemployment benefit=zasiłek dla bezrobotnych
wage=płaca, stawka godzinowa, tygodniowa
employ=zatrudniać
employee=pracownik
employer=pracodawca
employment=zatrudnienie
get on with your work=kontynuować pracę
work for a company=pracować w firmie
workplace=miejsce pracy 
apply for the position=ubiegać się o pracę na stanowisku
candidate=kandydat
career choice=wybór zawodu
career in=kariera zawodowa w
CV=CV
contract=umowa
employment agency=agencja pośrednictwa pracy
employment prospects=perspektywy zatrudnienia
enter the job/labour market=wejść na rynek pracy
job centre=urząd pracy
job interwiew=rozmowa kwalifikacyjna
job offer=oferta pracy
position|post=posada
reference=referencje
recruitment process=proces rekrutacji
requirements=wymagania
take on|hire=zatrudnić
the job/work involves=praca polega na
vacancy=wakat 
achievement=osiągnięcie
be fluent in English=posługiwać się biegle językiem angielskim
committed=zaangażowany, oddany
communication skills=zdolności komunikacyjne
competent=kompetentny
conscientious=skrupulatny, sumienny
efficient=wydajny 
experience in a field=doświadczenie w jakiejś dziedzinie
flexibility=umiejętność dostosowania się do nowych sytuacji
goal-oriented=zorientowany na cele
highly skilled/qualified/ motivated=o wysokich umiejętnościach / kwalifikacjach / silnej motywacji
 industrious=przedsiębiorczy
initiative=inicjatywa
previous professional/ job experience=dotychczasowe doświadczenie zawodowe
proactive=aktywny, pełen inicjatywy
qualifications=kwalifikacje
reliable=solidny, niezawodny
well-organised=zorganizowany
well-trained=dobrze wyszkolony
work well under pressure=umieć pracować pod presją
working knowledge of sth=praktyczna znajomość czegoś 
administrative work=kierowanie, zarządzanie
be in charge=nadzorować, być szefem
deal with=zajmować się czymś
delegate=rozdzielać obowiązki
go away on business=wyjeżdżać służbowo
keep the books=prowadzić księgowość
lead a team=stać na czele zespołu
management=zarządzanie
meet deadlines=dotrzymywać terminów
perform job duties=wykonywać obowiązki służbowe
review sb's performance=ocenić wyniki czyjejś pracy
supervise=nadzorować
take calls=odbierać telefony
work in a team/on your own=pracować w zespole/ samodzielnie
work to tight deadlines=pracować, dotrzymując napiętych terminów 
work/do overtime=pracować w nadgodzinach
Iearn on the job=uczyć się zawodu w praktyce
professional development=rozwój zawodowy
retrain=przekwalifikować się
training course=szkolenie
workshops= warsztaty 
ASAP|as soon as possible=jak najszybciej
FYEO| for your eyes only=poufne, do rąk własnych
FYI|for your information=do Twojej wiadomości 
be promoted=awansować, dostać awans
company car=samochód służbowy
flexible working hours=elastyczne godziny pracy
go on leave=pójść na zwolnienie, urlop
holiday pay=wynagrodzenie za czas urlopu
job satisfaction=zadowolenie z pracy
job security=pewność stałego zatrudnienia
lunch hour=przerwa na lunch
maternity/paternity leave=urlop macierzyński/ojcowski
perks|fringe benefits=dodatkowe świadczenia ze strony pracodawcy
prospects of promotion=perspektywy awansu
sick leave=zwolnienie lekarskie
sick pay=wynagrodzenie za czas choroby
take time/a day off=brać wolne /wolny dzień
work-life balance=równowaga między życiem prywatnym a zawodowym 
be self-employed=pracować na własny rachunek
build up your own business=stworzyć własną firmę
do freelance work=pracować jako wolny strzelec i na zlecenia 
do odd jobs=pracować dorywczo, wykonywać drobne prace
run your own business=prowadzić firmę
set up a company=założyć firmę
work from home=pracować zdalnie z domu 
early retirement=wcześniejsza emerytura
hand in your resignation/notice=złożyć wymówienie
job loss=utrata pracy
lay off|dismiss=zwolnić z pracy
make redundant=zwolnić, zredukować
quit|resign=zwolnić się, zrezygnować z pracy
redundancy=redukcja etatów
retire=przejść na emeryturę
sack|give the sack|fire=wyrzucić z pracy
voluntary redundancy=dobrowolne odejście z pracy 
cheap labour=tania siła robocza
exploit=wyzyskiwać
jobless|unemployed=bezrobotny
joblessness|unemployment=bezrobocie
labour costs=koszty pracy
outsource=przekazywać pracę, produkcję innym firmom
overworked=przepracowany
sit-in=strajk okupacyjny
strike=strajk
the unemployed=bezrobotni
trade union=związek zawodowy 
big fish=gruba ryba
call it a day=zakończyć pracę na dany dzień
climb the corporate ladder=wspinać się po szczeblach kariery
learn the ropes=nauczyć się fachu
pull a few strings=wykorzystać nieformalne kontakty
pull your weight=przyłożyć się
red tape=biurokracja
think on your feet=szybkie decyzje

[Unit 5 Życie towarzyskie i rodzinne]
adolescence=wiek dojrzewania
adolescent=osoba w wieku dojrzewania
adulthood=dorosłość
ageing=starzejący się
be in your prime=być w kwiecie wieku
be on your deathbed=być na łożu śmierci
grown-up=dorosły
grown-up=osoba dorosła
menopause=menopauza
minor=osoba nieletnia
newborn=noworodek
pensioner=emeryt, emerytka
retirement home=dom spokojnej starości
toddler=dziecko w wieku 1-2 lat
turn eighteen=skończyć osiemnaście lat
 underage=niepełnoletni
youngster=młoda osoba
youth=młodość,  młodzieniec,  młodzież 
ancestor=przodek
distant relative=daleki krewny
ex-husband=były mąż
ex-wife=była żona
first cousin=brat cioteczny, stryjeczny,  siostra cioteczna, stryjeczna
firstborn=pierworodny
godfather=ojciec chrzestny
godmother=matka chrzestna
great-aunt=cioteczna babka
great-uncle=cioteczny dziadek
half-brother=brat przyrodni
half-sister=siostra przyrodnia
in-laws=teściowie
nephew=bratanek,  siostrzeniec
next of kin=najbliższy krewny
niece=bratanica, siostrzenica
offspring=potomstwo
only child=jedynak
siblings=rodzeństwo 
spouse=małżonek, małżonka
stepbrother=przybrany brat
stepfather=ojczym
stepmother=macocha
stepsister=przybrana siostra
wife/husband-to-be=przyszła żona / przyszły mąż 
baptism|christening=chrzest
breastfeed=karmić piersią
cot|crib=łóżeczko dziecięce
expectant mother=kobieta spodziewająca się dziecka
give birth to a child=urodzić dziecko
labour=poród
maternity clothes=ubrania ciążowe
maternity ward=oddział położniczy
midwife=położna
nappy|diaper=pieluszka
pregnancy=ciąża
pregnant=w ciąży 
best man=drużba
bouquet=bukiet
bride=panna młoda
bridesmaid=druhna
church wedding=ślub kościelny
civil wedding=ślub cywilny
engagement=zaręczyny
engagement ring=pierścionek zaręczynowy
fiance=narzeczony
fiancee=narzeczona
get married=pobrać się
groom|bridegroom=pan młody
honeymoon=miesiąc miodowy
newlyweds=nowożeńcy
priest=ksiądz
propose=oświadczyć się 
registrar=urzędnik, urzędniczka stanu cywilnego
registry office=urząd stanu cywilnego
veil=welon
wedding ceremony=ceremonia zaślubin
wedding reception=wesele
wedding ring/band=obrączka ślubna
white wedding=tradycyjny ślub 
bury=pochować
cemetery|graveyard=cmentarz
coffin=trumna
cremation=kremacja
funeral parlour=dom pogrzebowy
grave=grób
headstone=nagrobek
hearse=karawan
mourn=opłakiwać
mourning=żałoba
undertaker=zakład pogrzebowy
urn=urna
wreath=wieniec 
family reunion=zjazd rodzinny
First Communion=Pierwsza Komunia Święta
hen party=wieczór panieński
housewarming party=parapetówka
stag party=wieczór kawalerski
Valentine's Day=walentynki
wedding anniversary=rocznica ślubu 
adopt=adoptować
adoptive parents=rodzice adopcyjni
biological parents=rodzice biologiczni
cohabiting couple=para żyjąca w konkubinacie
custody of a child=prawo do opieki nad dzieckiem
divorce=rozwód, rozwieść się
extended family=rodzina wielopokoleniowa 
foster care=opieka zastępcza
foster family=rodzina zastępcza
foster parents=rodzice zastępczy
generation=pokolenie
housewife|house husband=niepracująca żona, niepracujący mąż
immediate family=najbliższa rodzina
nuclear family=rodzina dwupokoleniowa
orphan=sierota
outside wedlock=poza małżeństwem
raise|bring up a child=wychowywać dziecko
same-sex couple=para homoseksualna
single/lone parent=samotny rodzic 
alimony=alimenty
breadwinner=żywiciel rodziny
budget=budżet
child maintenance=alimenty na dziecko
expense=wydatek
life insurance=ubezpieczenie na życie
pocket money=kieszonkowe
provide for/support one's family=utrzymywać rodzinę
will=testament 
acquaintance=znajomy, znajoma
classmate=kolega,  koleżanka z klasy
close friend=bliski przyjaciel
colleague|workmate=kolega, koleżanka z pracy
ex-schoolmate=były kolega, była koleżanka ze szkoły
friend of the family=przyjaciel,  przyjaciółka rodziny
mate|buddy|pal=kumpel
mutual friend=wspólny znajomy, wspólna znajoma
roommate|flatmate=współlokator, współlokatorka
travelling companion=towarzysz, towarzyszka podróży 
be fond of sb=lubić kogoś
confide in sb=zwierzać się komuś
date sb=chodzić z kimś
deal with sb=radzić sobie z kimś
easy to get on with=sympatyczny, taki, z którym można się dogadać
feel sick to death of sb=mieć kogoś, czegoś serdecznie dosyć
have a lot in common=mieć wiele wspólnego
know sb by sight=znać kogoś z widzenia
love at first=miłość od pierwszego wejrzenia
relate to sb=znaleźć z kimś wspólny język
responsibility=odpowiedzialność
stay in touch with sb=utrzymywać z kimś kontakt
take care of=zajmować się kimś, troszczyć się o kogoś
take sb for granted=nie doceniać kogoś 
abuse=znęcanie się, maltretowanie, wykorzystywanie
abuse sb=znęcać się nad kimś, wykorzystywać kogoś, maltretować kogoś
argue|quarrel|fight=kłócić się
be grounded=mieć szlaban
be strict with sb=być surowym wobec kogoś
behave childishly=zachowywać się dziecinnie
behave like a Iittle kid=zachowywać się jak małe dziecko
cheat on sb=zdradzić kogoś
domestic violence=przemoc domowa
dump|leave sb=rzucić kogoś
have an affair=mieć romans
have an argument/a fight/a row=pokłócić się
humiliate sb=upokorzyć kogoś
lose one's temper=stracić panowanie nad sobą
love-hate/stormy relationship=burzliwy związek 
mix with the wrong people=zadawać się z niewłaściwymi ludźmi
negotiate with sb=negocjować z kimś
overprotective=nadopiekuńczy
run away from home=uciec z domu
treat sb like an infant=traktować kogoś jak małe dziecko 
change the sheets=zmieniać pościel
clean the windows=myć okna
do household chores=wykonywać prace domowe
do the washing/Iaundry=robić pranie
fetch/collect the children from school=odebrać dzieci ze szkoły
give the children their bath=wykąpać dzieci
Ioad/empty the dishwasher=ładować/rozładowywać zmywarkę
make the bed=ścielić łóżko
mop the floor=myć podłogę
polish the silver=polerować srebra
put the rubbish out=wynieść śmieci
put the washing out|hang out the washing=wywiesić pranie
wash the car=myć samochód
water the plants=podlewać kwiaty 
eat out=jeść w restauracji
go clubbing=iść do klubu
hang out with friends=spotykać się ze znajomymi
leisure=wypoczynek
play board games/cards=grać w gry planszowe / karty
put your feet up=odpoczywać, relaksować
się stay up late=późno chodzić spać
take up a hobby/a sport=zająć się nowym hobby / zacząć uprawiać sport
throw a party=urządzać imprezę 
busy schedule=wypełniony harmonogram
drive yourself too hard=przepracowywać się
laze about/around=lenić się
time-poor=zabiegany, cierpiący na brak czasu
workaholic=pracoholik, pracoholiczka
yuppie=yuppie 
active=aktywny
carefree|relaxed=beztroski
comfortable=wygodny
demanding=wymagający
eccentric=ekscentryczny
extravagant|improvident=rozrzutny
feckless=lekkomyślny, nieprzewidujący
frugal=oszczędny
lavish=pełen przepychu
minimalist=minimalistyczny
opulent=wystawny
peaceful=spokojny
pressurised=stresujący
rewarding=satysfakcjonujący
tiring=męczący 
ask sb out=zaprosić kogoś na randkę
care for sb=troszczyć się o kogoś
I care for him=zależy mi na nim
fall for sb=zakochać się w kimś
fall out with sb=pokłócić się z kimś
get on with sb=dobrze się z kimś rozumieć
look back on sth=powracać wspomnieniami do czegoś
look down on sb=gardzić kimś
look up to sb=podziwiać kogoś
make up with sb=pogodzić się z kimś
rely on sb=polegać na kimś
sort out a problem=rozwiązać problem
split up|break up with sb=rozstać się z kimś
tell sb off=ganić, udzielać reprymendy 
be at each other's throats=skakać sobie do gardeł
be on the same wavelength=nadawać na tej samej fali
hate the sight of sb=nie cierpieć kogoś
have a crush on sb=podkochiwać się w kimś
have a soft spot for sb=mieć do kogoś słabość
not have the heart to do sth=nie mieć serca czegoś zrobić

[Unit 6 Zakupy i usługi]
apricot=morela
asparagus=szparagi
aubergine=bakłażan
beans=fasola
blackcurrant=czarna porzeczka
broccoli=brokuły
courgette=cukinia
cucumber=ogórek
garlic=czosnek
Iettuce=sałata
olive=oliwka
pepper=papryka
pumpkin=dynia
radish=rzodkiewka
raspberry=malina
soy beans=soja
spinach=szpinak
watermelon=arbuz 
bacon=boczek
beefsteak=befsztyk
cod=dorsz
flounder=flądra
herring=śledź
Iamb=jagnięcina
pork=wieprzowina
salmon=łosoś
sole=sola
trout=pstrąg
turkey=indyk
veal=cielęcina 
cereal products=produkty zbożowe
chewing gum=guma do żucia
cream=śmietana
dairy products=nabiał
mushroom=grzyb, pieczarka
nut=orzech
olive oil=oliwa
parmesan cheese=parmezan
rice=ryż
roll=bułka
seafood=owoce morza
seaweed=wodorosty
seeds=nasiona
spices=przyprawy
thyme=tymianek
vegetable oil=olej roślinny
meatballs=klopsiki
pasta=makaron
pastry=ciasto kruche
pork ribs=żeberka wieprzowe
roast chicken=pieczony kurczak
sausage roll=pasztecik z parówką 
appetising=apetyczny
bland=mdły, nijaki 
creamy=kremowy
crusty=chrupiący
decaffeinated=bezkofeinowy
fatty=tłusty
free-range=z wolnego chowu
homemade=domowej roboty
lean=chudy
organic=ekologiczny
pickled=marynowany
raw=surowy
savoury=słony, pikantny
sparkling=gazowany
still=niegazowany
spicy=ostry
stir-fried=smażony na sposób chiński
sugar-free=bezcukrowy
thick=gęsty
vegan=wegański
vegetarian=wegetariański
wholemeal=razowy 
animal fat=tłuszcz zwierzęcy
calcium=wapń
carbohydrates=węglowodany
cholesterol=cholesterol
fibre=błonnik
nutrients=składniki odżywcze
potassium=potas
protein=białko
starch=skrobia
unsaturated fats=tłuszcze nienasycone
vegetable fat=tłuszcz roślinny
vitamins=witaminy 
balanced diet=zrównoważona dieta
crash diet=intensywna dieta odchudzająca
cut down on fatty foods=ograniczyć tłuste produkty
dietary/eating habit=nawyki żywieniowe
digestion=trawienie
fad diet=dieta będąca chwilowo w modzie
fat-free=beztłuszczowy
food intolerance =nietolerancja pokarmowa
malnourished=niedożywiony
malnutrition=niedożywienie
Mediterranean diet=dieta śródziemnomorska
nutrition=odżywianie
processed foods=produkty przetworzone 
reduce fat/sugar intake=ograniczyć spożycie tłuszczu/cukru
starving=bardzo głodny 
add=dodać
bake=piec (chleb lub ciasto)
beat=ubijać jajka
boil=gotować, doprowadzać do wrzenia
chop up=siekać
cook=gotować, smażyć
cut=kroić
drain=odcedzać
fry=smażyć
grate=zetrzeć na tarce
ingredient=składnik
mince=zmielić
mix=mieszać, łączyć różne składniki
peel=obrać
recipe=przepis
roast= piec (mięso lub warzywa)
serve=podawać
slice=kroić na plasterki
stew=dusić
stir=mieszać jedną substancję łyżką
strip=pasek
whip=ubijać śmietanę 
bowl=miska
casserole=naczynie żaroodporne
crockery=naczynia
cutlery=sztućce
lid=przykrywka
mug=kubek
napkin=serwetka
place mat=podkładka pod talerz
pre-heated oven=nagrzany piekarnik
saucepan=rondel, garnek
can|tin=puszka
container=pojemnik
jar=słoik
loaf=bochenek
packet=paczka
tablespoon=łyżka stołowa
tub=plastikowe pudełko z przykrywką
tube=tubka 
a la carte=wybór z karty
chef=szef kuchni, wykwalifikowany kucharz
cold buffet=zimny bufet
dessert=deser
main course|entre=danie główne 
on the menu=w karcie
order=zamówić, zamówienie
set menu=gotowy zestaw
side dish/order=dodatek do dania głównego
snack=przekąska
starter|appetiser=przystawka
tip|gratuity=napiwek
wine list=karta win 
go bananas=wściec się
have a finger in every pie=maczać we wszystkim palce
it's no use crying over spilt milk=stało się, nie ma sensu płakać nad rozlanym mlekiem
it's not my cup of tea=nie przepadam za tym
sell like hot cakes=sprzedawać się jak świeże bułeczki
spili the beans=wygadać się, wyjawić tajemnicę 
butcher's=sklep mięsny
chain store=sklep należący do sieci
delicatessen|deli=delikatesy
DIY shop=sklep z narzędziami
fishmonger's=sklep rybny
garden centre=centrum ogrodnicze
greengrocer's=sklep z warzywami
newsagent's=kiosk z gazetami
off-licence=sklep z alkoholem
shopping mall=centrum handlowe
stationer's=sklep papierniczy
vending machine=automat z napojami, słodyczami
beauty products=kosmetyki
clothing=ubrania
consumer durables=towary trwałego użytku
electrical goods=urządzenia elektryczne
garment=część garderoby, jako towar
groceries=artykuły spożywcze
hardware=narzędzia, artykuły żelazne
household goods=artykuły gospodarstwa domowego
stationery=artykuły papiernicze
toiletries=artykuły do higieny osobistej 
attract customers=przyciągać klientów
deliver=dostarczyć 
good range/wide selection of products= szeroki wybór produktów
in stock/out of stock=dostępny/niedostępny w sprzedaży
marketing trick=sztuczka marketingowa
mail order=sprzedaż wysyłkowa
order sth online=zamówić coś przez Internet
same-day delivery=dostawa w dniu zakupu
shopaholic=osoba uzależniona od robienia zakupów
stock up on sth=uzupełnić zapasy towaru
window shopping=oglądanie wystaw sklepowych 
barcode=kod kreskowy
basket=koszyk
cashier=kasjer, kasjerka
checkout=kasa,  miejsce w supermarkecie
conveyor bełt=taśma przy kasie
queue=kolejka
receipt=paragon
till=kasa, urządzenie
trolley=wózek na zakupy 
bargain hunting=pogoń za okazjami
discount=zniżka
forty per cent off=czterdzieści procent zniżki
free of charge=za darmo
get a good deal=dostać dobrą ofertę
good value for money=wart swojej ceny
haggle|bargain=targować się
half price=za pół ceny
on special offer=w ofercie specjalnej
reasonable prices=rozsądne ceny
reduced|discounted=przeceniony
reduction=przecena
retail/wholesale price=cena detaliczna/ hurtowa
rock-bottom prices=ceny najniższe z możliwych
sale=wyprzedaż
two for the price of one=dwa produkty w cenie jednego 
astronomical prices=astronomiczne ceny
cost a smali fortune=kosztować fortunę
cost an arm and a leg=bardzo dużo kosztować 
daylight robbery=rozbój w biały dzień
exorbitant prices=wygórowane, przesadne ceny
rip-off=zdzierstwo 
pay by bank transfer=płacić przelewem bankowym
pay by credit/debit card=płacić kartą kredytową/debetową
pay in advance/up front=płacić z góry
pay in cash=płacić gotówką
pay in/by instalments=płacić w ratach
splash out on=wydać dużo pieniędzy na 
client/customer service advisor=pracownik działu obsługi klienta
consider a complaint=rozpatrzyć reklamację
dissatisfaction=niezadowolenie
dissatisfied=niezadowolony
exchange=wymienić
faulty=wadliwy
make a complaint|complain about sth=złożyć reklamację
malfunction=źle funkcjonować
offer a solution=zaproponować rozwiązanie
proof of purchase=dowód zakupu
receive a refund=otrzymać zwrot pieniędzy
refund sb's money|give sb a refund=zwrócić komuś pieniądze
replacement=towar na wymianę
return=zwrócić
unsatisfactory service=niezadowalająca obsługa
warranty|guarantee=gwarancja 
advertising slogan=hasło reklamowe
brand|make=marka
celebrity endorsement=udział gwiazdy w reklamie
comparative advertising=reklama porównawcza
direct mail=reklama wysyłana pocztą do domów
free sample=darmowa próbka
hoarding|billboard=billboard
out-of-home|outdoor advertising=reklama outdoorowa
pop-up ad=reklama internetowa w wyskakującym oknie
product placement=lokowanie produktu 
branch=oddział
card reader=czytnik kart 
cashpoint|cash machine|ATM|Automatic Teller Machine=bankomat
change money=rozmieniać, wymieniać pieniądze
charge=opłata
deposit=wpłacać
direct debit=polecenie zapłaty
exchange rates=kursy wymiany walut
interest=oprocentowanie
online transfer=przelew internetowy
open/close an account=otworzyć/zamknąć konto
overdraft=debet
pay interest on sth=płacić odsetki od czegoś
standing order=zlecenie stałe
take out a loan=zaciągnąć kredyt
withdraw=wypłacać
withdrawal=wypłata 
courier=kurier
dating service=serwis randkowy
dry cleaner's|the cleaner's=pralnia chemiczna
garage=warsztat samochodowy
laundrette=pralnia samoobsługowa
minicab=przewóz osób, taksówka na telefon
shoe/bicycle repair shop=punkt naprawy butów/rowerów
tailor|dressmaker=krawiec męski / krawiec damski
window cleaner=czyściciel okien 
car/health/travel/life insurance=ubezpieczenie samochodu/ zdrowotne/podróżnych/na życie
claim for sth on your insurance=zgłosić roszczenie ubezpieczeniowe
compensation|damages=odszkodowanie
comprehensive motor insurance=autocasco
cover=pokryć
damage=szkoda
insurance against sth=ubezpieczenie od czegoś
insurance broker/agent=agent ubezpieczeniowy
insurance claim=roszczenie ubezpieczeniowe
insurance policy=polisa ubezpieczeniowa
liability insurance|third party insurance=ubezpieczenie od odpowiedzialności cywilnej
take out insurance=ubezpieczyć się

[Unit 7 Podróżowanie i turystyka]
backpacking holiday=podróżowanie z plecakiem
beach/seaside holiday=wakacje nad morzem
camping holiday=wakacje pod namiotem
city break=krótki wyjazd turystyczny do dużego miasta
package holiday=wczasy zorganizowane
skiing holiday=wyjazd na narty
summer camp|holiday camp=obóz letni
touring holiday=objazdowy wyjazd turystyczny
trekking holiday=wakacje trekkingowe
walking holiday=wyjazd wędrowny 
B&B| bed & breakfast=pensjonat oferujący nocleg ze śniadaniem
be fully booked=nie mieć wolnych miejsc
book a room online=zarezerwować pokój przez Internet
budget accommodation=niedrogie zakwaterowanie
campsite=kemping
caravan|mobile home=przyczepa kempingowa
dormitory=sala wieloosobowa w schronisku
double room=pokój dwuosobowy z łożem małżeńskim
en suite facilities=łazienka w pokoju
holiday home/cabin=dom wakacyjny
hostel=hostel, schronisko
inn=gospoda, zajazd
mountain cabin=chata w górach
pitch=parcela na kempingu
self-catering accommodation=zakwaterowanie z możliwością korzystania z kuchni
single room=pokój jednoosobowy
suite=apartament
tent=namiot
three/five-star hotel=hotel trzy - pięciogwiazdkowy
triple room=pokój trzyosobowy
twin room=pokój dwuosobowy z dwoma łóżkami 
vacancy=wolny pokój
vacate a room=zwolnić pokój 
business trip=podróż służbowa
by land|by sea|by air=drogą lądową|morską|powietrzną
chaperone=przyzwoitka
circumnavigate=opłynąć| objechać|oblecieć dookoła
cruise=rejs statkiem wycieczkowym
destination=punkt docelowy
excursion=wycieczka
expedition=wyprawa, ekspedycja naukowa
journey=podróż
one-day trip=wycieczka jednodniowa
round-the-world trip=podróż dookoła świata
tour=podróż, wycieczka objazdowa
via=przez
voyage=rejs
westbound|eastbound| southbound|northbound=kierujący się na zachód| wschód|południe|północ
westwards|eastwards| southwards|northwards=na zachód/wschód/południe/ północ 
admission price=cena za bilet wstępu
attract tourists=przyciągać turystów
breathtaking/stunning/ amazing wiew of/over sth=zapierający dech w piersiach/ zachwycający/wspaniały widok na coś
guidebook=przewodnik książkowy
guided tour=wycieczka/zwiedzanie z przewodnikiem
holidaymaker=urlopowicz|urlopowiczka
overcrowded=zatłoczony
packed with tourists=pełen turystów
scenery=krajobraz
see the sights=zwiedzać
sightseeing tour=wycieczka ze zwiedzaniem
spectacular=widowiskowy, imponujący
tour guide=przewodnik|przewodniczka 
tour leader=pilot/ pilotka wycieczek
tour operator=touroperator
tourist destination=cel wycieczek turystycznych
touristy=nastawiony na turystów
unspoilt=nienaruszony 
amphitheatre=amfiteatr
canal=kanał
dungeon=loch
fountain=fontanna
historic site=zabytek, historyczne miejsce
landmark=charakterystyczny obiekt
marketplace=targ, bazar
mediewal fortress=średniowieczna twierdza
mosque=meczet
national park=park narodowy
Orthodox church=cerkiew
ruins=ruiny
statue=posąg
stone/wooden bridge=kamienny/drewniany most
synagogue=synagoga
temple=świątynia 
board the train=wsiąść do pociągu
carriage|car=wagon
compartment=przedział
conductor=konduktor|konduktorka
dining car=wagon restauracyjny
luggage rack=półka na bagaże
passenger=pasażer|pasażerka
platform=peron
railway|railroad=kolej
single ticket|one-way ticket=bilet w jedną stronę
sleeping car=wagon sypialny
tracks=tory
transcontinental=transkontynentalny
underground|the tube|subway=metro 
arrival=przylot
baggage reclaim=odbiór bagażu
baggage handler=bagażowy
boarding pass=karta pokładowa 
cabin crew=personel pokładowy
cancellation=odwołanie
cancelled=odwołany
check-in=odprawa biletowo-bagażowa
connecting flight=dalsze połączenie lotnicze
delay=opóźnienie
delayed=opóźniony
departure=odlot
departure lounge=poczekalnia dla odlatujących
domestic flight=lot krajowy
duty-free zone=strefa bezcłowa
excess baggage=nadbagaż
flight attendant=steward|stewardesa
gate=wyjście do samolotu
go through passport control/ customs/security=przejść odprawę paszportową / odprawę celną / kontrolę bezpieczeństwa
hand Iuggage=bagaż podręczny
international flight=lot międzynarodowy
last call=ostatnie wezwanie pasażera na pokład samolotu
leave one's luggage unattended=zostawić bagaż bez nadzoru
luxurious=luksusowy
runway=droga startowa
window/aisle seat=miejsce przy oknie/przejściu 
cabin=kabina
canoe=kanadyjka
crew=załoga
deck=pokład
disembark=zejść z pokładu
ferry=prom
good/rough crossing=spokojny/burzliwy rejs
lifeboat=łódź ratunkowa
liner=liniowiec
on board=na pokładzie
port=port
quay|quayside=nabrzeże
row|paddle=wiosłować
rudder=ster
sail=żeglować
sailing boat=żaglówka
seasickness=choroba morska
steamship=parowiec 
tall ship=żaglowiec
vessel=okręt
yacht=jacht 
accelerate=przyspieszać
accelerator=pedał gazu
bonnet|hood =maska samochodu 
boot|trunk=bagażnik
brake pedal=pedał hamulca
bumper|fender=zderzak
bus lane=buspas
car park|parking lot=parking
coach=autokar
change gear=zmienić bieg
carriage=wóz
dashboard=tablica rozdzielcza
do/make a U-turn=zawrócić
driver's seat=fotel kierowcy
fasten your seat belt=zapiąć pas bezpieczeństwa
fill up the tank=zatankować
gear lever=dźwignia zmiany biegów
gearbox=skrzynia biegów
give way=ustąpić pierwszeństwa
glove compartment=schowek przed siedzeniem pasażera
go through a red light=przejechać na czerwonym świetle
handbrake|emergency brake=hamulec ręczny
headlights=światła przednie
headrest=zagłówek
heavy traffic=duży ruch uliczny
hire/rent a car=wypożyczyć samochód
hitch=jechać autostopem
hitchhiker=autostopowicz|autostopowiczka
indicate=sygnalizować skręt
indicator|turn signal=kierunkowskaz
junction=skrzyżowanie
lane=pas ruchu
lorry|truck=ciężarówka
main/minor road=droga główna/drugorzędna
motorway|highway|freeway=autostrada
number plate=tablica rejestracyjna
overtake=wyprzedzać
passenger seat=fotel pasażera
pavement|sidewalk= chodnik
pedestrian crossing=przejście dla pieszych
petrol|gasoline=benzyna
petrol station|filling station=stacja benzynowa
put the car in gear/neutral=wrzucić bieg/luz 
put the handbrake on=zaciągnąć hamulec ręczny
rearview mirror=lusterko wsteczne
release the clutch=zwolnić sprzęgło
road sign=znak drogowy
spare tyre=koło zapasowe
speed camera=fotoradar
speeding=przekroczenie dozwolonej prędkości
speedometer=prędkościomierz
stall|I stalled the engine=silnik mi zgasł
standstill|traffic is at a standstill=ruch jest sparaliżowany
start the engine=uruchomić silnik
steering wheel=kierownica
strap a child in a car seat=zapiąć dziecko w foteliku samochodowym
switch on the ignition=przekręcić kluczyk w stacyjce
take the handbrake off=zwolnić hamulec ręczny
traffic jam|congestion=korek uliczny
vehicle=pojazd
windscreen=przednia szyba
wing mirror|side-view mirror=lusterko boczne
wipers=wycieraczki 
adjust the brakes=wyregulować hamulce/przerzutki
cycle lane=pas dla rowerów
cycle path=ścieżka rowerowa
frame=rama
handlebar=kierownica
light=światło
lock=linka do przypinania
oil the chain=oliwić łańcuch
patch the punctured inner tube=załatać dziurawą dętkę
pedal=pedał
pump=pompka rowerowa
pump up the tyres=pompować opony
remove and replace the wheel=założyć koło
saddle=siodełko 
shock absorber=amortyzator
valve=wentyl
water bottle=bidon 
A&E|Accident and Emergency| Casualty|Emergency Room=szpitalny oddział ratunkowy 
black box|flight recorder=czarna skrzynka
casualty|victim=ofiara
cause an accident=spowodować wypadek
collide=zderzyć się
crash into sth=zderzyć się z czymś
derail=wykoleić się
emergency exit=wyjście awaryjne
emergency landing=lądowanie awaryjne
first aid kit=apteczka pierwszej pomocy
give sb first aid=udzielić komuś pierwszej pomocy
head-on collision=zderzenie czołowe
life belt|life buoy=koło ratunkowe
life jacket=kamizelka ratunkowa
lose control of the steering=stracić panowanie nad kierownicą
maritime disaster|shipwreck=katastrofa morska
overturn=przewrócić się, dachować
oxygen mask=maska tlenowa
pile-up|multivehicle accident=karambol
plane crash|air disaster=katastrofa lotnicza
rescue operation=akcja ratunkowa
rescue services=służby ratunkowe
rescuer=ratownik|ratowniczka
scene of the accident=miejsce wypadku
sink|go down=zatonąć
skid=wpaść w poślizg
somersault=koziołkować
train wreck|train crash=katastrofa kolejowa
wreckage=wrak, szczątki 
be held up in a traffic jam=utknąć w korku
check in=przejść odprawę biletowo-bagażową
check in at the hotel|check out from the hotel=zameldować się w hotelu / wymeldować się z hotelu 
drop sb off at the hotel=wysadzić kogoś przy hotelu
look around=rozejrzeć się
pick sb up=odebrać kogoś
see sb off=odprowadzić kogoś
set off/out=wyruszyć
speed up=przyspieszać
take off=startować 
a stone's throw from=bardzo blisko
hit the road=wyruszyć
off the beaten track=na uboczu
thumb a lift=złapać stopalokazję
travel light=podróżować z małą ilością bagażu

[Unit 8 Kultura]
alto=alt
aria=aria
bar=takt
baritone=baryton
bass=bas
busk=występować jako grajek uliczny
busker=grajek uliczny
cellist=wiolonczelista| wiolonczelistka
choir=chór
chord=akord
concert hall=sala koncertowa
concerto=koncert (rodzaj utworu)
conductor=dyrygent
D major=D-dur
D minor=d-moll
drummer=perkusista|perkusistka
gig=koncert muzyki popularnej
guitarist=gitarzysta|gitarzystka
high-pitched|Iow-pitched/sound=wysoki|niski/dźwięk
in tune=nastrojony
sing in tune=śpiewać czysto
key=tonacja
lip-synch=śpiewać z playbacku
live music/performance=muzyka/występ na żywo
lyrics=słowa piosenki
note=nuta
opera house=opera (gmach)
orchestra=orkiestra
organist=organista
out of tune=rozstrojony
sing out of tune=fałszować
perfect pitch=słuch absolutny
performer=wykonawca|wykonawczyni
pianist=pianista
read music=czytać nuty
record label=wytwórnia płytowa
rehearse=robić próby
release an album=wydać płytę
score=partytura
soprano=sopran
symphony=symfonia
tenor=tenor
tour=jeździć na tournee
tune=melodia
tune an instrument=stroić instrument
violinist=skrzypek|skrzypaczka 
bass guitar=gitara basowa
cello=wiolonczela
clarinet=klarnet
double bass=kontrabas
drum=bęben
drums|drum kit=perkusja
flute=flet poprzeczny
grand piano=fortepian
harmonica=harmonijka ustna
harp=harfa
keyboard instruments=instrumenty klawiszowe
organ=organy
percussion instruments=instrumenty perkusyjne
recorder=flet prosty
saxophone=saksofon 
string instruments=instrumenty strunowe
trumpet=trąbka
upright piano=pianino
violin|fiddle=skrzypce
wind instruments=instrumenty dęte 
art installation=instalacja artystyczna
brush=pędzel
canvas=płótno
charcoal=węgiel
drawing=rysunek
easel=sztaluga
engraving=grafika, grawerunek
exhibit=eksponat
ink=atrament
landscape=pejzaż
model=model|modelka
nude=akt
oil painting=obraz olejny
palette=paleta
portrait=portret
sculptor=rzeźbiarz|rzeźbiarka
sculpture=rzeźba
self-portrait=autoportret
sketch=szkic
stili life=martwa natura
visual arts=sztuki plastyczne
watercolour=akwarela 
act=akt
adaptation=adaptacja
chapter=rozdział
character=postać
complexity=złożoność
depiction=przedstawienie, opisanie
description=opis
fiction=literatura piękna
final pages=ostatnie strony
genre=gatunek literacki
hardback=książka w twardej okładce
hero=główny bohater
heroine=główna bohaterka
illiterate=nieumiejący czytać
line=wers
metaphor=przenośnia
metaphorically=przenośnie
narrative=narracja
narrator=narrator
novel=powieść
novelist=powieściopisarz
opening paragraph/chapter=pierwszy akapit/rozdział
paperback=książka w miękkiej okładce
personification=uosobienie
play=sztuka
playwright=dramatopisarz|dramatopisarka
plot|storyline=fabuła
poet=poeta|poetka
poem=wiersz
poetry=poezja
rhyme=rym, rymować się
scene=scena
simile=porównanie
stanza=strofa, zwrotka
verse=zwrotka, strofa,  poezja, wiersz, wers 
acting=aktorstwo
adapt=zaadaptować
advance screening=pokaz przedpremierowy
appear in a film=pojawić się, grać w fiImie
based on a novel/a true story/real events=oparty na powieści / prawdziwej historii /prawdziwych wydarzeniach
ciematography=kinematografia
climax=punkt kulminacyjny
continuity=ciągłość akcji
director's cut=wersja reżyserska
double for sb=być czyimś dublerem
edit=montować
end credits=napisy końcowe
filming=kręcenie filmu
keep in suspense=trzymać napięciu
location=plener
on general release=na ekranach kin
pre-production=preprodukcja
prop|stage property=rekwizyt
ralease a movie=wprowadzić film na ekrany kin
screenplay=scenariusz
set =plan filmowy
shoot a film=kręcić film
soundtrack=ścieżka dźwiękowa
special effects=efekty specjalne
star=grać główną rolę
subtitles=napisy, lista dialogowa dołu ekranu
the film features=w filmie występuje/występują
the film is set in=akcja filmu rozgrywa się w 
blockbuster=hit kinowy
box-office hit=hit kasowy
documentary=film dokumentalny
feature film=film fabularny
low-budget film=film niskobudżetowy
prequel=film nawiązujący do innego filmu, dotyczący wcześniejszych wydarzeń
psychological thriller=thriller psychologiczny
rom-com=komedia romantyczna
sequel=kontynuacja, dalsza część filmu
series=serial
silent film=film niemy
tear-jerker=wyciskacz łez
trailer=zwiastun filmu 
cameraman=operator kamery
cast=obsada
cinematographer|director of photography= autor zdjęć do filmu
editor=montażysta|montażystka
extra=statysta|statystka
film crew=ekipa filmowa 
film critic=krytyk filmowy
make-up artist=charakteryzator|charakteryzatorka
male/female lead=główny aktor/aktorka
producer=producent|producentka
production designer|art director=scenograf
screenwriter|script writer=scenarzysta|scenarzystka
script supervisor=osoba nadzorująca ciągłość scenariusza
stunt mans|tunt woman=kaskader|kaskaderka 
aisle=przejście między rzędami krzeseł
backstage=za kulisami
box=loża
box office=kasa biletowa
circle|balcony=balkon w teatrze
curtain=kurtyna
drama school=akademia teatralna
gallery=najwyższy balkon, jaskółka
mime=pantomima
opera glasses=lornetka teatralna
orchestra pit=kanał dla orkiestry
prompter=sufler|suflerka
put on a play=wystawiać sztukę
stage=scena
stalls=miejsca na parterze
standing ovation=owacja na stojąco
troupe=trupa teatralna
understudy=dubler|dublerka 
broadsheet|quality paper=poważna gazeta
cartoonist=rysownik komiksów
channel=kanał telewizyjny
circulation=nakład
column=stała rubryka, felieton
columnist=felietonista|felietonistka
comic|cartoon strip=historyjka obrazkowa
cover story=artykuł zapowiedziany na okładce
editorial=artykuł wstępny
gossip column=kronika towarzyska
issue|edition=wydanie, numer
live coverage=transmisja na żywo
make/hit the headlines=trafić na pierwsze strony gazet
publish=opublikować
publisher=wydawca
publishing house|publishing company=wydawnictwo
tabloid=brukowiec 
convey=przekazywać idee i uczucia
critical opinion=opinia krytyczna
express=wyrażać
move to tears ta=poruszać do łez
offend people's feelings=obrażać czyjeś uczucia
outsider's point of wiew=punkt widzenia osoby z zewnątrz
pose questions=stawiać pytania
provoke=prowokować
receive critical acclaim=zdobyć uznanie krytyków 
action-packed=o wartkiej akcji
appealing=pociągający
avant-garde= awangardowy
comical=komiczny
complex=złożony, skomplikowany
controversial=kontrowersyjny
convincing=przekonujący
disturbing=niepokojący
extraordinary=nadzwyczajny
eye-catching=przyciągający wzrok
far-fetched=naciągany
highly recommended=gorąco polecany
hilarious=zabawny
impressive=wywierający wrażenie, poruszający
innovative=nowatorski
intricate=zawiły, kunsztowny
intriguing=intrygujący
masterly=mistrzowski
meaningful=znaczący
memorable=zapadający w pamięć
multi-dimensional=wielowymiarowy
poignant=przejmujący
politically involved=zaangażowany politycznie
profound=głęboki, dogłębny
radical=radykalny
relevant=istotny, trafny
shocking=szokujący
sophisticated=wyrafinowany
spectacular=spektakularny, widowiskowy
spellbinding=urzekający
stunning=zachwycający
subtle=subtelny
superficial=powierzchowny
thought-provoking=zmuszający do myślenia
true-to-life=autentyczny
unconvincing=nieprzekonujący
vivid=sugestywny, obrazowy 
audience=widownia, publiczność
onlooker=gap, osoba przypatrująca się
spectator=widz wydarzenia sportowego
viewer=widz telewizyjny lub filmowy
visitor=zwiedzający 
be an open book=być jak otwarta książka, nie skrywać żadnych tajemnic
he's not as black as he's painted=nie taki diabeł straszny, jak go malują
music to my ears=to mnie bardzo cieszy
play the second fiddle=grać drugie skrzypce
put the finishing touches to sth=nanosić ostatnie poprawki
strike the right note=uderzyć w odpowiedni ton
turn over a new leaf=rozpocząć nowy rozdział w życiu

[Unit 9 Zdrowie, sport]
artery=tętnica
blood circulation=krążenie krwi
blood vessel=naczynie krwionośne
brain=mózg
breathing=oddychanie
bronchi=oskrzela
digestion=trawienie
heartbeat=bicie serca
joints=stawy
kidney=nerka
Iarynx=krtań
ligament=więzadło
liver=wątroba
Iungs=płuca
muscle=mięsień
neurons=neurony
small/large intestine=jelito cienkie/grube
spinal cord=rdzeń kręgowy
stomach=żołądek, brzuch
tendon=ścięgno
testicle=jądro
uterus=macica
vein=żyła 
circulatory system=układ krwionośny
digestive system=układ trawienny
locomotor system=układ mięśniowo-szkieletowy
nervous system=układ nerwowy
reproductive system=układ rozrodczy
respiratory system=układ oddechowy
urinary system=układ moczowy 
addictive=uzależniający
be allergic to=być uczulonym na
catch a cold=przeziębić się
contract an infectious disease=zarazić się chorobą zakaźną
cure=wyleczyć
diagnose sb with an illness=zdiagnozować u kogoś chorobę
diagnosis=diagnoza
get injured=doznać urazu
heal=goić się
injury=uraz 
make a full recovery=w pełni wrócić do zdrowia
obesity=otyłość
premature death=przedwczesna śmierć
recover=wracać do zdrowia
reduce blood pressure=obniżyć ciśnienie krwi
refer sb to a specialist=skierować kogoś do specjalisty
suffer from=cierpieć, chorować na
treat=leczyć, poddawać kuracji
treatment=leczenie, kuracja
wound=zranić, rana 
aching muscles=bóle mięśniowe
backache=ból pleców
blister=pęcherz
constipation=zaparcie
cough=kaszleć, kaszel
diarrhoea=biegunka
earache=ból ucha
feel dizzy=mieć zawroty głowy
rash=wysypka
swollen=spuchnięty 
injection=zastrzyk
medication|drug=lekarstwo
OTC|over-the-counter  drug=lek bez recepty
painkiller=lek przeciwbólowy
prescription drug=lek na receptę
remedy=lekarstwo, środek zaradczy
side effect=skutek uboczny
wonder drug=cudowny lek 
come down with the flu=zachorować na grypę
come round=odzyskać przytomność
cut down on sth=ograniczyć coś
cut sth out=wyeliminować coś
pass out=zemdleć
pick up an infection=złapać infekcję 
AIDS=AIDS
Alzheimer's disease=choroba Alzheimera 
appendicitis=zapalenie wyrostka robaczkowego
bronchitis=zapalenie oskrzeli
cancer=rak
cholera=cholera
conjunctivitis=zapalenie spojówek
dementia=demencja
depression=depresja
diabetes=cukrzyca
epidemic=epidemia
heart attack=zawał serca
heart disease|cardiovascular disease=choroba serca
hepatitis=zapalenie wątroby
high blood pressure=nadciśnienie tętnicze
leukaemia=białaczka
otitis=zapalenie ucha
plague=dżuma
pneumonia=zapalenie płuc
smallpox=czarna ospa
stroke=udar mózgu
tuberculosis|TB= gruźlica 
bandage=bandaż
bruise=siniak
concussion=wstrząs mózgu
in plaster|in a cast=w gipsie
open fracture=otwarte złamanie
plaster=plaster opatrunkowy
pull a muscle=naciągnąć mięsień
scar=blizna
scratch=zadrapać,  zadrapanie
sling=temblak
sprain/twist your wrist/your ankle=skręcić nadgarstek / nogę w kostce
stitches=szwy
syringe=strzykawka
walk on crutches=chodzić o kulach 
amputated limb=amputowana kończyna
amputation=amputacja
autism=autyzm
blind=niewidomy
deaf=głuchy
disability=niepełnosprawność, kalectwo 
hearing-impaired|hard of hearing=niedosłyszący
intellectually disabled|mentally handicapped=niepełnosprawny intelektualnie
sign language=język migowy
visually impaired=niedowidzący
wheelchair= wózek inwalidzki 
GP|generał practitioner=lekarz pierwszego kontaktu
nurse=pielęgniarz|pielęgniarka
nutritionist|dietician=dietetyk|dietetyczka
paramedic=ratownik medyczny|ratowniczka medyczna
pharmacist=farmaceuta|farmaceutka
physiotherapist=fizjoterapeuta|fizjoterapeutka
plastic surgeon=chirurg plastyczny
psychiatrist=psychiatra
speech therapist=logopeda 
as right as rain=zdrów jak ryba
be going strong=być w doskonałym stanie, dobrze się trzymać
feel under the weather=czuć się źle
he took a turn for the worse=pogorszyło mu się
look the picture of health=być okazem zdrowia
recharge your batteries=naładować akumulatory, odzyskać energię 
air the room=wietrzyć pokój
avoid stress=unikać stresu
balanced diet=zrównoważona dieta
BMI |Body Mass Index=BMI
dental hygiene=higiena jamy ustnej
follow a sensible diet=rozsądnie się odżywiać
get enough sleep=wysypiać się
improve flexibility=poprawić gibkość
manage stress=radzić sobie ze stresem
moderate/vigorous/strenuous exercise=umiarkowane/ intensywne/forsowne ćwiczenia
personał hygiene=higiena osobista
sedentary lifestyle=siedzący tryb życia 
wellness=wellness
wellness work out=ćwiczyć
workout=trening, ćwiczenia
yoga=joga 
alcoholic=alkoholik|alkoholiczka
alcoholism=alkoholizm
be clean=być czystym, nie brać narkotyków
become addicted to=uzależnić się od
cannabis|marijuana=marihuana
compulsive gambling=uzależnienie od hazardu
designer drugs=dopalacze
do drugs=brać narkotyki
dope=narkotyk
drug/nicotine addict=osoba uzależniona od narkotyków/nikotyny
highly addictive=silnie uzależniający
junkie=ćpun
nicotine patch=plaster antynikotynowy
overdose=przedawkować
party drugs=narkotyki przyjmowane na dyskotekach
rehab=odwyk
substance/drug abuse=przyjmowanie środków odurzających/narkotyków 
archery=łucznictwo
athletics|track and field=lekkoatletyka
bungee jumping=skoki na bungee
cross-country skiing=narciarstwo biegowe
cycling=kolarstwo
discus=rzut dyskiem
fencing=szermierka
figure skating=łyżwiarstwo figurowe
golf=golf
high jump=skok wzwyż
ice hockey=hokej na lodzie
javelin=rzut oszczepem
kite surfing=kite surfing
long jump=skok w dal
long-distance running=biegi na długim dystansie
pole vault=skok o tyczce
pool=pool, rodzaj bilardu
relay=sztafeta
scuba diving=nurkowanie z akwalungiem
 swimming=pływanie
 volleyball=siatkówka
 whitewater rafting=spływ górską rzeką
wrestling=zapasy 
basket=kosz
basketball court=boisko do koszykówki
centre=środkowy
first/second quarter=pierwsza/druga kwarta
shooting guard=rzucający obrońca
slam dunk=wsad
three-point shot=rzut za trzy punkty 
first/second half=pierwsza/druga połowa meczu
football pitch=boisko do piłki nożnej
goal=bramka
goalkeeper=bramkarz|bramkarka
hit the post=trafić w słupek
offside=spalony
own goal=bramka samobójcza
penalty shoot-out=seria rzutów karnych
referee=sędzia w piłce nożnej
save a penalty=obronić rzut karny
striker=napastnik 
backhand=bekhend
doubles=debel
forehand=forhend
game|set|match=gem|set|mecz
serve=serwować, serwis
serve an ace=zdobyć asa serwisowego
smash=smecz
tennis court=kort tenisowy
umpire=sędzia w tenisie 
badminton/tennis/squash racket=rakieta do tenisa/badmintona/ squasha
barbell=sztanga
baseball/cricket bat=kij bejsbolowy/ krykietowy
golf club=kij golfowy
hockey stick=kij do hokeja
pool/snooker cue=kij bilardowy/snookerowy
puck=hokejowy
shuttlecock=lotka do badmintona
table tennis bat=rakietka do tenisa stołowego 
compete=współzawodniczyć
complete a race=ukończyć wyścig
cup=puchar
extra time|overtime=dogrywka
foul=sfaulować 
knock sb out=znokautować kogoś
lead by 20 points=prowadzić 20 punktami
league=liga
score=strzelić gola, zdobyć punkt
shoot=strzelać
substitute=zmienić zawodnika
training session=sesja treningowa
warm up=rozgrzać się
warm-up session=rozgrzewka 
athlete=lekkoatleta| lekkoatletka
captain=kapitan
champion=mistrz| mistrzyni
coach|trainer=trener|trenerka
competitor|opponent|rival=rywal| rywalka|przeciwnik|przeciwniczka
fan=kibic
reserve player=zawodnik rezerwowy | zawodniczka rezerwowa
team-mate=kolega/ koleżanka z drużyny
top/leading scorer=główny strzelec, król strzelców 
anabolic steroids=sterydy anaboliczne
banned substances=niedozwolone substancje
blood doping=doping krwi
growth hormone=hormon wzrostu
increase stamina=zwiększyć wytrzymałość
performance-enhancing drugs=środki dopingujące 
FIFA World Cup=mistrzostwa świata w piłce nożnej
fight/boxing match=walka bokserska
Paralympics=igrzyska paraolimpijskie
race=wyścig
round=runda
the Olympic Games|the Olympics=igrzyska olimpijskie
tournament=turniej 
beat=pokonać
he tested positive/negative for= wykryto / nie wykryto u niego
hold a sporting event=organizować imprezę sportową
host a sporting event=być gospodarzem imprezy sportowej
run a marathon=brać udział w maratonie 

[Unit 10 Nauka i technika]
add=dodawać 
addition=dodawanie
circumference=obwód  okręgu
cone=stożek
constant=stała
coordinate system=układ współrzędnych
 cube=sześcian
cylinder=walec
divide=dzielić
division=dzielenie
equation=równanie
exponent= wykładnik potęgi
fraction=ułamek
multiplication=mnożenie
multiply=mnożyć
perimeter=obwód
rectangle=prostokąt
root=pierwiastek
sphere=kula
subtract=odejmować
subtraction=odejmowanie
triangle=trójkąt 
air pressure=ciśnienie atmosferyczne
alternating current=prąd zmienny
atom=atom
atomic bomb=bomba atomowa
elementary particle=cząstka elementarna
emit=emitować
gamma radiation=promieniowanie gamma
gas=gaz
gravity=grawitacja
Higgs boson=bozon Higgsa
liquid=ciecz
neutron=neutron
nuclear fission=rozszczepienie jądra atomu
nucleus=jądro atomu
solid=ciało stałe
surface tension=napięcie powierzchniowe
ultraviolet radiation=promieniowanie ultrafioletowe
velocity=prędkość 
wormhole=tunel czasoprzestrzenny 
barium=bar
calcium=wapń
chemical compound=związek chemiczny
chemical reaction=reakcja chemiczna
chlorine=chlor
crystal=kryształ
element=pierwiastek
hydrochloric acid=kwas solny
hydrogen=wodór
iron=żelazo
lead=ołów
mercury=rtęć
minerał salts=sole mineralne
molecule=cząsteczka
nitrogen=azot
oxygen=tlen
periodic table=układ okresowy
peroxide=woda utleniona
sodium chloride=chlorek sodu
solution=roztwór
sulphuric acid=kwas siarkowy
test tube=probówka
uranium=uran 
archaeological site=stanowisko archeologiczne
artefact=artefakt
excavations=wykopaliska
mummy=mumia
papyrus=papirus
pharaoh=faraon
prehistoric=prehistoryczny
pyramid=piramida
tomb=grobowiec 
big bang=wielki wybuch
black hole=czarna dziura
dark matter=ciemna materia
galaxy=galaktyka
orbit=orbita, obieg  wokół Słońca
orbit=okrążać
planet=planeta
rover=łazik
solar system=Układ Słoneczny
space probe=sonda kosmiczna
spacecraft=statek kosmiczny 
spacetime=czasoprzestrzeń
universe=wszechświat 
advanced treatments=zaawansowane metody leczenia
antibiotics=antybiotyki
antibiotic-resistant bacteria=bakterie odporne na antybiotyki
appendicitis=zapalenie wyrostka robaczkowego
autopsy=sekcja zwłok
cell=komórka
die in childbirth=umrzeć przy porodzie
DNA=DNA
evolve=rozwijać się, ewoluować
fatal=śmiertelny
genetic code=kod genetyczny
genetics=genetyka
habitat=siedlisko
 infectious/contagious disease=choroba zakaźna
internal organs=organy wewnętrzne
microscopic=mikroskopijny
nervous system=układ nerwowy
organism=organizm
penicillin=penicylina
reproduction=rozmnażanie
species=gatunek
tissue=tkanka 
aerospace engineer=inżynier lotnictwa i kosmonautyki
archaeoiogist=archeolog
astronomer=astronom
astrophysicist=astrofizyk
chemist=chemik
cosmologist=kosmolog
Egyptologist=egiptolog
experimental/theoretical physicist=fizyk eksperymentalny/ teoretyczny
geneticist=genetyk
geographer=geograf 
linguist=językoznawca
mathematician=matematyk
microbiologist=mikrobiolog
neuroscientist=neurobiolog
pathologist=patolog
psychologist=psycholog 
accept=zaakceptować
analyse=analizować
analysis=analiza
assertion=twierdzenie
carry out/conduct an experiment=przeprowadzić eksperyment
collaborate with sb on a project=współpracować z kimś nad projektem
confirm findings=potwierdzić wyniki badań
construct=konstruować
control group=grupa kontrolna
criterion=kryterium
discover=odkryć
do research=prowadzić badania
duplicate sb's results=powtórzyć wyniki czyichś badań
 formula=równanie
 formulate a hypothesis=sformułować hipotezę
hypothesis=hipoteza
hypothetical=hipotetyczny
invent=wynaleźć
obtain=otrzymać
phenomenon=zjawisko
publish=opublikować
receive/be awarded|the Nobel Prize=otrzymać Nagrodę Nobla
reject=odrzucić
supported by evidence=wsparty dowodami
untested observations=niesprawdzone obserwacje 
gunpowder=proch strzelniczy
jet engine=silnik odrzutowy
microchip=mikroczip 
printing press=prasa drukarska
steam engine=maszyna parowa 
flat battery=wyczerpana bateria
go dead=paść, rozładować się
landline=telefon stacjonarny
reception=zasięg
ring tone=dzwonek
there's no signal=nie ma zasięgu
voice mail=poczta głosowa 
anti-virus software=oprogramowanie antywirusowe
app|application=aplikacja
browser=przeglądarka internetowa
compress a file=skompresować plik
computer hacker=haker komputerowy
database=baza danych
desktop=pulpit
display/screen resolution=rozdzielczość ekranu
drag the icon=przeciągnąć ikonę
file extension=rozszerzenie pliku
firewall=zapora sieciowa
folder=folder
icon=ikona
inbox=skrzynka odbiorcza
Internet scam=oszustwo internetowe
memory stick=karta pamięci
online banking service=bankowość internetowa
operating system=system operacyjny
password=hasło
peripherals=urządzenia peryferyjne
printer=drukarka
protective software=oprogramowanie zabezpieczające
recover your password/a file=odzyskać hasło/plik
register=zarejestrować się
scroll up/down=przewijać stronę w górę/dół
search=wyszukiwać
search engine=wyszukiwarka
search results=wyniki wyszukiwania 
security question=pytanie kontrolne
shortcut=skrót
uninstall/reinstall software=odinstalować/zainstalować ponownie program
update=aktualizacja
update=aktualizować
upload=przesyłać dane z komputera
username=nazwa użytkownika
Wi-Fi Internet access=dostęp do Internetu przez Wi-Fi
word processor=edytor tekstu 
attractive design=atrakcyjny wygląd
battery-operated=zasilany z baterii
durable=trwały
lightweight=lekki
long battery life=długi czas pracy baterii
portable=przenośny
rechargeable=nadający się do ponownego ładowania
state-of-the-art=najnowocześniejszy
touch screen=ekran dotykowy
user-friendly=przyjazny dla użytkownika 
DVD|digital video/versatile disc=DVD
HD|high definition=wysokiej rozdzielczości
LCD|liquid crystal display=wyświetlacz ciekłokrystaliczny
LED|light-emitting diode=dioda LED
RAM|random access memory=pamięć o dostępie swobodnym
www|World Wide Web=ogólnoświatowa sieć 
adapter=przejściówka
adjust=wyregulować
change/replace a light bulb=zmienić żarówkę
charge=naładować
charger=ładowarka
earth|ground=uziemienie
extension lead=przedłużacz
plug=wtyczka
power=zasilanie
press the button=wcisnąć guzik 
remote control=pilot zdalnego sterowania
socket=gniazdko
switch=przełącznik 
blank screen=pusty ekran
blow=przepalić się
bounce back=odbić się, o wiadomości e-mail
broken|out of order=zepsuty
crash=zawiesić się
electric shock=wstrząs elektryczny
error message=komunikat o błędzie
fuse=bezpiecznik
leak=przeciekać
leak|leakage=wyciek
mend|fix|repair=naprawić
paper jam=zator papieru
power surge=przepięcie
power/electricity cut=przerwa w dostawie prądu
restart|reboot=zrestartować
safety precautions=środki bezpieczeństwa
short circuit=krótkie spięcie
spare parts=części zamienne
spark=iskra, iskrzyć
stop responding=przestać reagować na komendy
troubleshooting guide=zasady postępowania w przypadku wystąpienia problemów 
freeze up=zawiesić się
plug in=podłączyć
put together=złożyć
set up=rozstawić
sign in|log in|log on=zalogować się
sign out|log out|log off=wylogować się
switch off|turn off=wyłączyć
switch on|turn on=włączyć
take apart=rozebrać
turn up/down=podgłośnić/śdszyć
wind up=nakręcać 
acid test=próba ogniowa, trudny sprawdzian
all the bells and whistles=bajery, dodatki
blow a fuse=wpaść w szał
it's not rocket science=to nie jest wielka filozofia
reinvent the wheel=kombinować niepotrzebnie, szukać nowego sposobu na zrobienie czegoś
run out of stearn=stracić parę

[Unit 11 Świat przyrody]
bay=zatoka
canal=kanał
cape=przylądek
cliff=skała
coastline=linia brzegowa
dense forest=gęsty las
dunes=wydmy
estuary=ujście rzeki
flood plain=równina zalewowa
gorge=wąwóz
grassland=łąka, obszar trawiasty
gulf=zatoka
island=wyspa
man-made lake=sztuczne jezioro
meadow=łąka
mountain range=pasmo górskie
open fields=otwarty teren
peak=szczyt górski
peninsula=półwysep
pond=staw
rainforest=las deszczowy
river=rzeka
riverside=brzeg rzeki
waterfall/falls=wodospad
wetland=teren podmokły
woodland=teren leśny 
bark=kora
birch=brzoza
chestnut=kasztanowiec, kasztan
clover|shamrock=koniczyna
crocus=krokus
daffodil=żonkil
daisy=stokrotka
forget-me-not=niezapominajka
heather=wrzos
leek=por
lily=lilia
lily of the valley=konwalia
maple=klon
oak=dąb
pansy=bratek
pine=sosna
rose=róża
snowdrop=przebiśnieg
spruce=świerk
tangerine tree=drzewo mandarynkowe
thistle=oset
tulip=tulipan 
beaver=bóbr 
breed=rasa
bristle=szczecina
carnivore=mięsożerca
chick=pisklę
crocodile=krokodyl
cuckoo=kukułka
donkey=osioł
eagle=orzeł
elephant=słoń
emperor penguin=pingwin cesarski
European bison=żubr
giraffe=żyrafa
goat=koza
hedgehog=jeż
herbivore=roślinożerca
hippo|hippopotamus=hipopotam
lynx=ryś
magpie=sroka
mammal=ssak
monitor lizard=waran
mouse=mysz
owl=sowa
pigeon=gołąb
predator=drapieżnik
prey=ofiara, żer drapieżnika
raven=kruk
seagull=mewa
sheep=owca
snout=pysk
sparrow=wróbel
species=gatunek
stork=bocian
swan=łabędź
tusk=kieł
zebra=zebra 
bark=szczekać
bite=gryźć
breed=rozmnażać się
feed=żywić się, karmić
graze=paść się na trawie
hatch=wykluwać się
have young=mieć młode
hibernate=zapadać w sen zimowy
hunt=polować
incubate eggs=wysiadywać jaja
lay eggs=składać jaja
mate=łączyć się w pary
migrate=migrować
nest=gnieździć się 
air pressure=ciśnienie powietrza
biizzard=zamieć śnieżna 
blow=wiać
breeze=lekki wiatr
chilly=chłodny
cloudy=pochmurny
downpour=ulewa
drizzle=mżawka
dull=szary, pochmurny
extreme temperatures=ekstremalne temperatury
fog=mgła
freezing=bardzo zimny, lodowaty
frost=mróz
frosty=mroźny
gale|gale-force wind=wichura
hail=grad
heatwave=fala upałów
heavy snowfall=obfite, silne opady śniegu
high humidity=wysoka wilgotność powietrza
light showers=przelotne opady
microciimate=mikroklimat
mist|haze=lekka mgiełka
overcast sky=zachmurzone niebo
pour with rain|rain heavily=mocno padać, lać o deszczu
rainbow=tęcza
rainfall=opady deszczu
rainstorm=burza
scorching=skwarny
sleet=śnieg z deszczem
snowfall=opady śniegu
snowstorm=burza śnieżna
soaring temperatures=bardzo wysokie temperatury
sunshine=światło słoneczne
sweltering=parny, duszny, gorący
thick clouds=gęste chmury
thunderstorm=burza z piorunami
torrential rain=ulewny deszcz
unfavourable=niesprzyjający 
avalanche=lawina
drought=susza
earthquake=trzęsienie ziemi
famine=klęska głodu 
flood=powódź
hurricane=huragan
landslide=osuwisko
melt=roztopić się
overflow=wylać o rzece
tectonic plate=płyta tektoniczna
tornado=tornado
tsunami|tidal wave=tsunami
typhoon=tajfun
volcanic eruption=wybuch wulkanu 
agriculture=rolnictwo
biodiversity=różnorodność w przyrodzie
carbon footprint=ślad węglowy, całkowita emisja gazów cieplarnianych
ecosystem=ekosystem
endemic species=gatunek endemiczny występujący na określonym terenie
give off oxygen=wydzielać tlen
habitat=siedlisko
in the wild=w naturalnym środowisku
lush vegetation=bujna roślinność
ozone layer=warstwa ozonowa
polar ice cap=polarna czapa lodowa
sea level=poziom morza
well-adapted to the environment=dobrze przystosowany do środowiska
wildlife=dzika fauna i flora 
alternative energy sources=alternatywne źródła energii
biofuel=biopaliwo
crude oil/petroleum=ropa naftowa
fossil fuels=paliwa kopalne
fracking|hydraulic fracturing=szczelinowanie hydrauliczne
geothermal energy=energia geotermalna
hydroelectric power plant=elektrownia wodna
hydroelectricity=energia elektryczna z elektrowni wodnych
methane=metan
natural gas=gaz ziemny
nuclear energy=energia jądrowa 
oil refinery=rafineria ropy naftowej
oil tanker=tankowiec przewożący ropę naftową
petrol=benzyna
renewable energy=energia odnawialna
seaweed=wodorosty
shale gas=gaz łupkowy
solar cell=ogniwo słoneczne
sustainable/green energy=energia zrównoważona
unleaded petrol=benzyna bezołowiowa
wind farm=elektrownia wiatrowa
wind power=energia wiatru
wind turbine=turbina wiatrowa 
acid rain=kwaśny deszcz
air pollution=zanieczyszczenie powietrza
become extinct=wyginąć
carbon dioxide=dwutlenek węgla
climate change=zmiana klimatu
commercial forestry=leśnictwo komercyjne
consumerist lifestyle=konsumpcyjny styl życia
contaminate=zanieczyszczać
deforestation=wycinanie lasów
degradation=degradacja
disposable containers=pojemniki jednorazowego użytku
emission=emisja
endangered species=zagrożony gatunek, zagrożone gatunki
environmental disaster=katastrofa ekologiczna
exhaust fumes=spaliny
extinction=wymarcie, wyginięcie
fell trees=ścinać drzewa
global warming=globalne ocieplenie
greenhouse effect=efekt cieplarniany
greenhouse gas=gaz cieplarniany
harmful to the environment=szkodliwy dla środowiska
have a negative impact=wpływać negatywnie
hunt=polować
irreparable damage=szkody nie do naprawienia 
landfill=wysypisko śmieci
log rainforests=wycinać lasy deszczowe
melting of glaciers=topnienie lodowców
oil spill=wyciek ropy
overpopulation=przeludnienie
pollution=zanieczyszczenie środowiska
soil erosion=erozja gleby
threat=zagrożenie
toxic waste=odpady toksyczne
waste natural resources=marnować surowce naturalne 
biodegradable=ulegający biodegradacji
bring sth under stricter control=wprowadzić bardziej surową kontrolę czegoś
carbon neutral=niewydzielający dwutlenku węgla
conserve water and energy=oszczędzać wodę i energię
consume less=zużywać czegoś mniej
cycle lane=pas dla rowerów
cycle path=ścieżka rowerowa
do away with sth=zlikwidować coś
eco-friendly|environmentally friendly=przyjazny dla środowiska
ecological activist=działacz ekologiczny
energy-saving lighting=oświetlenie energooszczędne
environmental sustainability=stabilność ekologiczna, zrównoważony rozwój
generate less pollution=wytwarzać mniej zanieczyszczeń
green products=produkty ekologiczne
locally grown food=żywność produkowana lokalnie
lower/reduce CO, emissions=obniżyć emisję dwutlenku węgla
minimise one's impact on the environment=zminimalizować swój wpływ na środowisko
organic food=żywność ekologiczna
phase sth out=stopniowo coś eliminować z użycia 
plant trees=sadzić drzewa
recycle=ponownie przetwarzać
recycling=recykling
redress the natural balance=przywrócić naturalną równowagę
reduce traffic congestion=zmniejszać zagęszczenie ruchu
sort rubbish=sortować odpady
use public transport=korzystać z transportu publicznego
wildlife reserve|sanctuary=rezerwat przyrody 
asteroid|planetoid=asteroida
black hole=czarna dziura
comet=kometa
constellation=gwiazdozbiór
dust= pył
electromagnetic radiation=promieniowanie elektromagnetyczne
equinox=równonoc
galaxy=galaktyka
high/low tide=przypływ/odpływ
light year=rok świetlny
lunar/solar eclipse=zaćmienie Słońca/Księżyca
meteor shower=rój meteorów
meteorite=meteoryt
nebula=mgławica
orbit=orbita, obieg wokół Słońca
orbit=okrążać
phases of the moon=fazy Księżyca
pulsar=pulsar
red giant=czerwony olbrzym
rotate=obracać się dookoła własnej osi
shooting/falling star=spadająca gwiazda
solstice=przesilenie zimowe/letnie
supernova=supernowa
white dwarf=biały karzeł 
as the crow flies=w linii prostej
feel like a fish out of water=czuć się jak ryba wyjęta z wody
he wouldn't hurt a fly=nie skrzywdziłby nawet muchy
look like something the cat brought in=wyglądać jak nieszczęście
there's no room to swing a cat=nie ma się jak obrócić

[Unit 12 Państwo i społeczeństwo]
branches of government=gałęzie władzy
constitutional monarchy=monarchia konstytucyjna
democracy=demokracja
headquarters=siedziba główna
multi-party system=system wielopartyjny
official residence=oficjalna rezydencja
separation of powers=podział władz
vest a right in sb=nadać komuś prawo 
amendment to the Constitution=poprawka do konstytucji
control the budget=kontrolować budżet
legislative power| legislature=władza ustawodawcza
Member of Parliament|MP=członek parlamentu, poseł, posłanka
Parliament=parlament
pass new laws=uchwalać nowe ustawy
ratify=ratyfikować
the Senate=senat
United States Congress=Kongres Stanów Zjednoczonych 
administer the country=rządzić krajem
administration=administracja
cabinet|government=rząd
executive power=władza wykonawcza
implement laws=wdrażać ustawy
monarch=monarcha
President=prezydent
Prime Minister|PM=premier
Secretary of State=sekretarz stanu 
apply the law=stosować prawo
court of law=sąd
interpret the law=interpretować prawo
punishment=kara
punish offenders=karać przestępców 
resolve disputes=rozstrzygać spory
judiciary power=władza sądownicza 
censorship=cenzura
citizen=obywatel, obywatelka
civil liberties=swobody obywatelskie
communicate ideas and opinions=głosić poglądy
due process of law=właściwa procedura prawna
fair trial=sprawiedliwy proces
form/join/leave organisations=zakładać organizacje/wstępować do organizacji /występować z organizacji
freedom of assembly=wolność zgromadzeń
freedom of association=wolność zrzeszania się
freedom of conscience=wolność sumienia
freedom of religion=wolność religii
freedom of speech and expression=wolność słowa
gather=zbierać się
hold moral/religious views=mieć poglądy moralne/ religijne
presume sb innocent=uważać kogoś za niewinnego
prove sb guilty=udowodnić czyjąś winę
represent=reprezentować
restrictions based on race/social status/wealth=ograniczenia ze względu na rasę/pozycję społeczną/majątek
right to bear arms=prawo do noszenia broni
rights of the accused=prawa oskarżonego
the Bill of Rights=Karta Praw
universal suffrage=powszechne prawo wyborcze
violate sb's rights=naruszać czyjeś prawa 
aid=pomoc humanitarna 
bribe=przekupić, łapówka
bribery=łapówkarstwo
corrupt=korumpować, skorumpowany
corruption=korupcją
corruption scandal=skandal korupcyjny
destitution=nędza, ubóstwo
discriminate against sb=dyskryminować kogoś
discrimination=dyskryminacja
embezzlement=defraudacja
embezzle=zdefraudować
equal opportunities=równouprawnienie, równe szanse
ethnic prejudice=uprzedzenia na tle etnicznym
evict=wyeksmitować
favouritism=kumoterstwo
homeless=bezdomny
homelessness=bezdomność
illiteracy=analfabetyzm
impunity=bezkarność
lack of transparency=brak przejrzystości
poor=biedny
poverty=bieda
race=rasa
racism=rasizm
shelter=schronisko
sleep rough=spać pod gołym niebem
social benefits=świadczenia socjalne
social inequality=nierówności społeczne
social security=opieka społeczna, zasiłek
starvation=głód
unemployed=bezrobotny
unemployment=bezrobocie 
aide=asystent, asystentka polityka
confidential=poufny
conspiracy|plot=spisek
cover sth up=zatuszować coś
forthcoming elections=nadchodzące wybory
fundraising=zbieranie funduszy
general election=wybory powszechne
hear evidence=wysłuchać zeznań 
high treason=zdrada stanu
impeach=postawić w stan oskarżenia
impeachment=impeachment, postawienie w stan oskarżenia
internal politics=polityka wewnętrzna
Iandslide election victory=przytłaczające zwycięstwo w wyborach
opinion poll=badanie opinii publicznej
opposition leader=lider opozycji
re-elect=wybrać ponownie
re-election=reelekcja
resign=złożyć rezygnację
run a campaign=prowadzić kampanię 
boom=boom gospodarczy
commercial enterprise=przedsiębiorstwo handlowe
consumer confidence=zadowolenie z sytuacji ekonomicznej
corporate sector=sektor korporacyjny
decrease|drop|go down|fall=spaść, zmniejszyć się
decrease|fall=spadek
demand=popyt
domestic trade=handel wewnętrzny
downturn=spadek, schyłek koniunktury
economic crisis=kryzys gospodarczy
economic growth=wzrost gospodarczy
economic recovery=uzdrowienie gospodarki
economical=oszczędny
economics=ekonomia
economise=oszczędzać, oszczędnie gospodarować
economist=ekonomista
expenditure=wydatki
export=eksport
foreign trade=handel zagraniczny
funding=finansowanie
GDP|gross domestic product=PKB|produkt krajowy brutto
go bankrupt=zbankrutować
import=import
income=dochód
increase|rise=wzrost
increase|grow|go up|rise by 50%=wzrosnąć, zwiększyć się o 50%
increase borrowing=zwiększyć zadłużenie
interest rate=poziom oprocentowania
loss=strata
private/public sector=sektor prywatny/ publiczny
profit=zysk
public debt=dług publiczny
public spending|government spending=wydatki publiczne
recession=recesja
stock market crash=krach na giełdzie
supply and demand=podaż i popyt
tax=podatek
the Great Depression=Wielki Kryzys
trade union=związek zawodowy 
armed conflict=konflikt zbrojny
assassination=zamach
assassinate sb=dokonać zamachu na kogoś
casualty=ofiara
civil war=wojna domowa
civilian=cywil
defence=obrona
outbreak of war=wybuch wojny
peace treaty=traktat pokojowy
armed robbery= napad z bronią w ręku
arson=podpalenie
assault=napaść
attempted murder/burgiary=próba zabójstwa/włamania
blackmail=szantażować, szantaż
breach of peace=zakłócenie porządku publicznego
bullying=prześladowanie
bully=prześladować, prześladowca, prześladowczyni
burglary=włamanie
commit a crime=popełnić przestępstwo
cyberbullying=prześladowanie w Internecie
demand ransom=zażądać okupu
falsify=sfałszować
force a window/a door=wyważyć okno/drzwi
forgery=fałszerstwo, falsyfikat
forge=podrobić
fraud=oszustwo, oszust, oszustka
hijacking=porwanie np. samolotu
hijack=porwać np. samolot 
hołd sb hostage=przetrzymywać kogoś jako zakładnika
identity theft=kradzież tożsamości
manslaughter=nieumyślne spowodowanie śmierci
misdeed=występek
mugging=rozbój, napaść uliczna
offender=przestępca, przestępczyni
set fire to sth=podpalić coś
siphon off money=nielegalnie wyprowadzać pieniądze
teenage delinquent=młodociany przestępca
terrorist=terrorysta, terrorystyczny
terrorism=terroryzm
vandalise=zdewastować
vandal=wandal
vandalism=wandalizm 
accuse sb of sth=oskarżyć kogoś o coś
alibi=alibi
appeal against the conviction=odwoływać się od wyroku skazującego
arrest=aresztować
charge sb with sth=oskarżyć kogoś o coś
community service=prace społeczne
conspiracy theory=teoria spiskowa
convict=skazany
convict sb of sth=skazać kogoś za coś
criminal trial=proces karny
drop the charges=wycofać zarzuty
eligible for parole=uprawniony do ubiegania się o zwolnienie warunkowe
evidence=dowody
find sb guilty/innocent of sth=uznać kogoś winnym/niewinnym czegoś
hold sb in custody=przetrzymywać kogoś w areszcie śledczym
identity parade=okazanie
imprison=uwięzić
imprisonment=uwięzienie
interfere with witnesses=wpływać na świadków
jury=ława przysięgłych
Iaunch an inquiry=rozpocząć dochodzenie
plead guilty/not guilty/innocent=przyznać /nie przyznać się do winy
power of attorney=pełnomocnictwo 
prison term=kara pozbawienia wolności
release sb on bail=zwolnić kogoś za kaucją
search a house/a flat/a person=przeszukać dom/mieszkanie/ osobę
search warrant=nakaz rewizji
security camera=kamera monitoringu
sentence to/ for=skazać na karę/za 
serve the prison sentence=odsiedzieć karę
stand trial=stanąć przed sądem
suspect=podejrzany
suspect sb of sth=podejrzewać kogoś o coś
try=sądzić, rozpatrywać sprawę w sądzie 
charity organisation=organizacja charytatywna
EU|the European Union=Unia Europejska
foundation=fundacja
NATO|North Atlantic Treaty Organisation=NATO, Organizacja Traktatu Północnoatlantyckiego
NGO|non-governmental organisation=organizacja pozarządowa
non-profit organisation=organizacja non-profit
UN|the United Nations=ONZ|Organizacja Narodów Zjednoczonych
UNESCO|the United Nations Educational, Scientific and Cultural Organisation=UNESCO|Organizacja Narodów Zjednoczonych do Spraw Oświaty, Nauki i Kultury
UNICEF|United Nations Children's Fund=UNICEF| Fundusz Narodów Zjednoczonych na rzecz Dzieci
WHO|World Health Organisation=WHO, Swiatowa Organizacja Zdrowia 
break off talks/negotiations=zerwać rozmowy/negocjacje
bring about=spowodować
come out of recession, crisis=wyjść z kryzysu
give in=poddać się, ustąpić
invest in=inwestować w
pay off debts=spłacić długi
set up a firm=założyć firmę
step down=złożyć rezygnację ze stanowiska
come into force=wejść w życie
come to a head=osiągnąć punkt krytyczny
come to Iight=wyjść na jaw
go bust=zbankrutować
take the floor=zabrać głos
