[Longman - podstawy]

[Unit 1 CZŁOWIEK]
age=wiek 
birth=narodziny
date of birth=data urodzenia
place of birth=miejsce urodzenia
citizen=obywatel
divorced=rozwiedziony
female=kobieta
first name=imię
job=zawód
male=mężczyna
marital status=stan cywilny
married=żonaty/ zamężna
nationality=narodowość
occupation/profession= zawód wymagający kwalifikacji
personal details=dane osobowe
sex=płeć
single=stanu wolnego
surname|family name=nazwisko
widow=wdowa
widower=wdowiec
ankle=kostka
arm=ręka
back=plecy
body=ciało
bottom=pupa
chest=klatka piersiowa
elbow=łokieć
finger=palec
fist=pięść
foot=stopa
feet=stopy
forearm=przedramię
hand=ręka
head=głowa
heel=pięta
hip=biodro
knee=kolano
leg=noga
neck=szyja
shoulder=ramię
skin=skóra
stomach=brzuch
thigh=udo
thumb=kciuk
toe=palec u stopy
waist=talia
wrist=nadgarstek
cheek=policzek
chin=podbródek
ear=ucho
eye=oko
eyebrow=brew
eyelash=rzęsa
face=twarz
forehead=czoło
jaw=szczęka
lip=warga
mouth=usta
nose=nos
throat=gardło
tongue=język
tooth=ząb
teeth=zęby
casual=nieformalny, codzienny
classy=szykowny
dress code=zasady dotyczące ubioru
elegant/smart=elegancki
fashionable=modny
formal=formalny
label=metka
designer labels=ubrania od znanych projektantów
outfit=strój
quality=jakość
good quality=dobrej jakości
stunning=olśniewający
style=styl
stylish=stylowy
anorak=kurtka przeciwdeszczowa
blouse=bluzka
boxer shorts=bokserki
bra=stanik
clothes=ubrania
coat=płaszcz
dress=sukienka
jacket=marynarka, żakiet, kurtka
jeans=dżinsy
jumper=sweter
pants=majtki/spodnie
pullover=pulower
pyjamas=piżama
shirt=koszula
shorts=szorty
skirt=spódnica
sock=skarpetka
suit=garnitur
sweater=sweter
sweatpants=spodnie dresowe
sweatshirt=bluza
hooded sweatshirt=bluza z kapturem
tie=krawat
tights=rajstopy
top=top
football top=koszulka piłkarska
tracksuit=dres
tracksuit bottoms=spodnie od dresu
trousers=spodnie
T-shirt=podkoszulka
underpants=slipy
underwear=bielizna
uniform=mundur
school uniform=mundurek szkolny
accessories=akcesoria
baseball cap=czapka z daszkiem
belt=pasek
boots=kozaki
bracelet=bransoletka
briefcase=teczka/aktówka
earrings=kolczyki
fl at shoes=buty na płaskim obcasie
glasses=okulary
gloves=rękawiczki
handbag=torebka
hat=kapelusz
high-heeled shoes=buty na wysokim obcasie
jewellery=biżuteria
necklace=naszyjnik
piercing=piercing
sandals=sandały
scarf=szalik/apaszka
shoes=buty
sunglasses=okulary przeciwsłoneczne
trainers=buty sportowe
woolly hat=czapka zimowa
baggy=luźny
checked=w kratę
comfortable=wygodny
cotton=bawełniany
denim=dżinsowy
knitted=zrobiony na drutach
leather=skórzany
lightweight=lekki
patterned=wzorzysty
silk=jedwabny/jedwab
sleeveless=bez rękawów
striped=w paski
tight=obcisły
waterproof=nieprzemakalny
woolly=wełniany
dress=ubierać się
fi t=pasować pod względem rozmiaru
match=pasować pod względem koloru
suit=pasować do osoby
wear=nosić, mieć na sobie
dress up=ubrać się elegancko
dress up as sb/sth=przebrać się za kogoś/coś
get a haircut=ostrzyc się
get dressed=ubrać się
get one’s hair done=zostać uczesanym przez fryzjera
get one’s nails done=pójść do manikiurzystki
go to a fancy-dress party=iść na bal kostiumowy
iron a shirt=wyprasować koszulę
polish shoes=wypastować buty
put on clothes=zakładać ubranie
put on make-up=nakładać makijaż
take off clothes=zdjąć z siebie ubranie
attractive=atrakcyjny
beautiful=piękny
good-looking=przystojny, atrakcyjny
gorgeous=olśniewający
handsome=przystojny
pretty=ładny
scruffy=niechlujny
ugly=brzydki
child=dziecko
children=dzieci
elderly=w starszym wieku
in his/her early twenties=po dwudziestce
in his/her late thirties=przed czterdziestką
in his/her mid fifties=około pięćdziesięciu pięciu lat
middle-aged=średnim wieku
old=stary
teenager=nastolatek
young=młody
foot=stopa jednostka miary używana do opisu wzrostu
six feet two inches= 6 stóp 2 cale
height=wzrost
of medium height=średniego wzrostu
short=niski
tall=wysoki
broad shoulders=szerokie ramiona
build=budowa ciała
athletic build=sportowa sylwetka
fat=gruby
fi t=w dobrej formie, wysportowany
muscular arms=umięśnione ręce
overweight= z nadwagą
plump=puszysty
skinny/thin=chudy
slim=szczupły
well-built=dobrze zbudowany
bald=łysy
curly=kręcone
dark=ciemne
dyed=farbowane
fair= jasne
fringe=grzywka
ginger/red=rude
grey/white=siwe
hair=włosy
ponytail=kucyk
shiny=lśniące
shoulder-length=do ramion
spiky=nastroszone
straight=proste
wavy=faliste
appearance=wygląd
beard=broda
complexion=cera
pale complexion=blada cera
tanned complexion=opalona cera
freckles=piegi
go bald=łysieć
looks=wygląd
make-up=makijaż
moustache=wąsy
put on weight=przybierać na wadze
scar=blizna
shave one’s head =ogolić sobie głowę
smile=uśmiech
lovely smile=ładny uśmiech
tattoo=tatuaż
wrinkles=zmarszczki
aggressive=agresywny
ambitious=ambitny
apologetic=przepraszający
argumentative=lubiący dyskutować, kłótliwy
arrogant=arogancki
artistic=uzdolniony artystycznie
bossy=apodyktyczny
brave=odważny
bright=bystry
calm=opanowany
careful=ostrożny
careless=nieostrożny
caring=troskliwy
cheerful=radosny
clever=zdolny, inteligentny, sprytny
cold=oschły, chłodny
compassionate=współczujący
conceited=zarozumiały
confi dent=pewny siebie
cruel=okrutny
dependent=zależny, na czyimś utrzymaniu
independent=niezależny
disciplined=zdyscyplinowany
dull=nieciekawy
easy-going=łatwy w obejściu, wyluzowany
friendly=przyjazny
unfriendly=nieprzyjazny
funny=zabawny
generous=szczodry, wspaniałomyślny, uczynny
gentle=łagodny
hard-working=pracowity
helpful=uczynny, pomocny
honest=uczciwy
dishonest=nieuczciwy
hospitable=gościnny
insecure=niepewny
intelligent=inteligentny
irony=ironia
kind=miły, uprzejmy
unkind=niemiły, nieuprzejmy
kind-hearted=dobrotliwy, o wielkim sercu
lazy=leniwy
lively=żywiołowy
loyal=lojalny
disloyal=nielojalny
mature=dojrzały
immature=niedojrzały
mean=skąpy
messy=nieporządny
modest=skromny
immodest=nieskromny
nasty=wstrętny
neat=staranny
open-minded=o otwartym umyśle
narrow-minded=ograniczony
outgoing=otwarty, towarzyski
patient=cierpliwy
impatient=niecierpliwy
peaceful=spokojny
personality=osobowość
polite=uprzejmy
impolite=nieuprzejmy
politeness=uprzejmość
quiet=cichy
rebellious=buntowniczy
relaxed=wyluzowany
reliable=godny zaufania
reserved=powściągliwy
responsible=odpowiedzialny
irresponsible=nieodpowiedzialny
rude=niegrzeczny
self-confi dent=pewny siebie
selfish=samolubny
selfl ess=bezinteresowny
sense of humour=poczucie humoru
sensible=rozsądny
sensitive=wrażliwy
insensitive=niewrażliwy
shallow=płytki
shy=nieśmiały
sociable=towarzyski
unsociable=nietowarzyski
stubborn=uparty
stupid=głupi
talkative=gadatliwy
tolerant=tolerancyjny
intolerant=nietolerancyjny
vain=próżny
violent=agresywny, porywczy
wise=mądry
annoyed=zirytowany
annoying=irytujący
bored=znudzony
boring=nudny
depressed=załamany
depressing=przygnębiający
disappointed=rozczarowany
disappointing=rozczarowujący
embarrassed=zażenowany, zawstydzony
embarrassing=wprawiający w zażenowanie
excited=podekscytowany
exciting=ekscytujący
frightened=przerażony
frightening=przerażający
frustrated =sfrustrowany
frustrating=frustrujący
miserable=nieszczęśliwy
moved=wzruszony
moving=wzruszający
pleased=zadowolony
stressed out=zestresowany
surprised=zdziwiony
surprising=zadziwiający
worried=zmartwiony
worrying=martwiący
admire=podziwiać
adore=uwielbiać
detest=nie znosić
dislike=nie lubić
hate=nienawidzić
like=lubić
reject=odtrącić
respect=szanować
be angry with sb=być złym na kogoś
be afraid of sb/sth=bać się kogoś/czegoś
be attracted to sb=uważać, że ktoś jest pociągający
be/feel/get fed up with sb/sth=mieć kogoś/czegoś dość
be fond of sb/sth=lubić kogoś/coś
be good at sth=być w czymś dobrym
be in a good/bad mood=w dobrym/złym nastroju
be interested in sth=interesować się czymś
be keen on sth=bardzo coś lubić
be nervous about sth=denerwować się czymś
can’t stand sb/sth=nie cierpieć kogoś/czegoś
change one’s mind=zmienić zdanie
cheer up=rozweselić, rozchmurzyć się
do sb a favour=zrobić komuś przysługę
fall in love with sb=zakochać się w kimś
feel like sth=mieć na coś ochotę
function well under stress=dobrze funkcjonować pod wpływem stresu
get a laugh=wywoływać śmiech
get to know someone=poznać kogoś
grow up=dorastać
have a bad day=mieć zły dzień
have something in common with sb=mieć coś wspólnego z kimś
in aid of sth=na rzecz czegoś
laugh at sb/sth=śmiać się z kogoś/czegoś
look down on sb=patrzeć na kogoś z góry, pogardzać kimś
look up to sb=podziwiać kogoś
lose one’s temper=stracić panowanie nad
sobą make fun of sb=wyśmiewać się z kogoś
make sb laugh=rozśmieszać kogoś
make up one’s mind=zdecydować się
put sb in a good mood= wprawiać kogoś w dobry nastrój
speak in a funny voice=mówić śmiesznym głosem
take part in sth=brać w czymś udział
talk to a stranger=rozmawiać z nieznajomym
tell a joke=opowiedzieć dowcip
worry about sth=martwić się czymś

[Unit 2 DOM]
attic/loft=strych, poddasze
balcony=balkon
basement/cellar=piwnica
bathroom=łazienka
bedroom=sypialnia
ceiling=sufit
high ceililng=wysoki sufit
chimney=komin
corridor=korytarz
door=drzwi
back door=tylne drzwi
front door=drzwi frontowe
doorway=wejście, drzwi
downstairs=na dole
drive=podjazd
fence=płot
floor=piętro, podłoga
wooden floor=drewniana podłoga
flowerbed=klomb
games room=pomieszczenie rekreacyjne
garage=garaż
underground garage=garaż podziemny
garden=ogród
front garden= ogród z przodu budynku
rear garden=ogród z tyłu budynku
gate=furtka
hall=przedpokój
kitchen=kuchnia
laundry=pralnia
lawn=trawnik
letterbox=skrzynka na listy
living room|sitting room=pokój dzienny, salon
path=ścieżka
porch=ganek
roof =dach
roof  terrace=taras na dachu
rooftop=dach
staircase=klatka schodowa
stairs=schody
step=schodek
study=gabinet
toilet=toaleta
upstairs=na górze
wall=ściana
WC=ubikacja
window=okno
apartment|flat=mieszkanie
block of flats=blok mieszkalny
building=budynek
office builiding=biurowiec
residential builiding=budynek mieszkalny
bungalow=dom parterowy
castle=zamek
cottage=domek wiejski
detached house=dom wolnostojący
farmhouse=dom w gospodarstwie wiejskim
high rise|tower block=wieżowiec
houseboat=łódź mieszkalna
mansion=luksusowa rezydencja
one-bedroom flat=mieszkanie z jedną sypialnią
semi-detached house=połówka bliźniaka
skyscraper=drapacz chmur
studio flat=kawalerka
terraced house=dom szeregowy
two-roomed flat=mieszkanie dwupokojowe
blind=roleta, żaluzja
central heating=centralne ogrzewanie
clock=zegar
curtain=zasłona
door handle=klamka
doorbell=dzwonek
doormat=wycieraczka do butów
electrical appliances=urządzenia elektryczne
fitted carpet=wykładzina dywanowa
fitting=element instalacji, armatura
furniture=meble
antique furniture=zabytkowe meble
household appliances=sprzęt AGD
light=lampa
light bulb=żarówka
net curtain=ranka
plant=roślina
house plant=roślina doniczkowa
radiator=grzejnik
vacuum cleaner=odkurzacz
wallpaper=tapeta
windowsill=parapet okienny
bath=wanna
mirror=lustro
shower= prysznic
soap=mydło
tap=kran
toothbrush=szczoteczka do zębów
towel=ręcznik
washbasin=umywalka
washing machine=pralka
bed=łóżko
bunk bed=łóżko piętrowe
double bed=łóżko dwuosobowe
bedding=pościel
bedside table=szafka nocna
blanket=koc
bookshelf=półka na książki
chair=krzesło
chest of drawers=komoda
desk=biurko
dressing table=toaletka
duvet=kołdra, pierzyna
fitted wardrobe=szafa wnękowa
lamp=lampa
mattress=materac
pillow=poduszka
rug=dywanik
sheet=prześcieradło
shelf=półka
wardrobe=szafa
armchair=fotel
audio system|stereo=sprzęt audio
bookcase=biblioteczka
carpet=dywan
CD player=odtwarzacz płyt CD
coffee table=stolik kawowy
couch/sofa=kanapa
cushion=poduszka dekoracyjna
dining table=stół jadalny
fireplace=kominek
TV set= telewizor
cooker=kuchenka
electric cooker=kuchenka elektryczna
crockery=zastawa stołowa
cupboard=szafka kuchenna
cutlery=sztućce
dishwasher=zmywarka
freezer=zamrażarka
fridge=lodówka
kettle=czajnik
electric kettle=czajnik elektryczny
kitchen table=stół kuchenny
microwave oven=kuchenka mikrofalowa
microwave with a grill=kuchenka mikrofalowa z funkcją grilla
oven=piekarnik
running water=bieżąca woda
sink=zlew
teapot=dzbanek do herbaty
toaster=toster
ancient=starożytny, wiekowy, bardzo stary
bare=pusty
bright=jasny
comfortable=wygodny
uncomfortable=niewygodny
cosy=przytulny
furnished=umeblowany
unfurnished=nieumeblowany
in bad condition=w złym stanie
in good condition=w dobrym stanie
messy= nieuporządkowany, zabałaganiony
modern=nowoczesny
neat=schludny
old-fashioned=staroświecki, staromodny
recently renovated=odnowiony, po remoncie
roomy/spacious=przestronny
stylish=stylowy
tidy=uporządkowany
tiny=malutki
collapse|fall down=walić się
do up one’s house|redecorate=odnowić dom
accommodation=zakwaterowanie
amenities/facilities=udogodnienia, infrastruktura
bill=rachunek
electricity bill=rachunek za prąd
excluding bills=rachunki niewliczone w cenę
including bills=rachunki wliczone w cenę
telephone bill=rachunek za telefon
en suite bedroom=pokój z łazienką
estate agent=agent nieruchomości
estate agent’s offi ce=biuro agenta nieruchomości
flatmate=współlokator
for sale=na sprzedaż
fully fitted kitchen=w pełni wyposażona kuchnia
house rules=zasady panujące w domu
landlady=osoba wynajmująca komuś mieszkanie, pokój (kobieta)
landlord=osoba wynajmująca komuś mieszkanie, pokój (mężczyzna)
location=położenie
on-street parking=parking na ulicy
per month=miesięcznie
per week=tygodniowo
public transport=transport publiczny
reasonable price=rozsądna cena
rent=czynsz
roommate=współlokator, z którym dzielimy pokój
spare room=pokój gościnny
tenant=najemca
to let=do wynajęcia
view=widok
can/could afford sth=móc sobie pozwolić na coś
exchange flats=zamienić się mieszkaniami
find a place of your own=znaleźć swój kąt
let a flat=wynajmować mieszkanie komuś
pay in advance=płacić z góry
pay the bills=płacić rachunki
pay the rent=płacić czynsz
rent a flat=wynajmować mieszkanie od kogoś
share a flat with sb=dzielić z kimś mieszkanie
split the costs=dzielić się kosztami
area=okolica
capital|capital city=stolica
city=duże miasto
conveniently located=dogodnie położony
countryside|the country|village=wieś
district=okręg, dzielnica
easy access to sth=łatwy dostęp do czegoś
home town=miasto rodzinne
housing estate=osiedle mieszkaniowe
inhabitant/resident=mieszkaniec
neighbour=sąsiad
neighbourhood=okolica
old town=starówka
residential area=dzielnica mieszkaniowa
rural=wiejski
slums=slumsy
suburbs=przedmieścia
tourist resort=kurort
tourist town=miasto turystyczne
town=miasto
underground station=stacja metra
urban=miejski
across the street=po drugiej stronie ulicy
at the top of a building|on the top floor=na ostatnim piętrze
by the sea=nad morzem
go inside=wejść do środka
in front of=przed
in the city centre=w centrum miasta
in the countryside=na wsi
in the suburbs=na przedmieściach
next to=obok
on the corner=na rogu
on the first floor=na pierwszym piętrze
on the outskirts of a city=na obrzeżach miasta
opposite=naprzeciwko
turn into a street=skręcić w ulicę
walk along a street= iść ulicą
walk past sth=minąć coś
within walking distance of cinemas=w bliskiej odległości od kin
clean=myć, sprzątać
commute=dojeżdżać do pracy
cook=gotować
vacuum=odkurzać
be at home|be in=być w domu
change light bulbs=zmieniać żarówki
clean the bathroom=sprzątać łazienkę
clean the floors=myć podłogi
clean the windows=myć okna
clean up=sprzątać
clear up the mess=posprzątać bałagan
clear up the table=sprzątać ze stołu
do household jobs|do the housework=wykonywać prace domowe
do the cleaning=sprzątać
do the cooking=gotować
do the dishes|the washing-up=myć naczynia
do the ironing=prasować
do the shopping=robić zakupy
do the washing=prać
draw the curtains=zaciągać zasłony
dry the dishes=wycierać naczynia
dust the surfaces=ścierać kurze
empty the dishwasher=wyjmować naczynia ze zmywarki
feel homesick=tęsknić za domem
get home=dotrzeć do domu
hang up the washing=wieszać pranie
iron clothes=prasować ubrania
leave the house=wychodzić z domu
lie on the bed=leżeć na łóżku
lock the door=zamknąć drzwi na klucz
make the beds=ścielić łóżka
mend a dripping tap=naprawiać cieknący kran
mop the floor=myć podłogę mopem
move house=przeprowadzać się
move in=wprowadzać się
move out=wyprowadzać się
mow the lawn=kosić trawę
put away clothes=układać, odkładać na miejsce ubrania
take out the rubbish=wynosić śmieci
throw out=the rubbish wyrzucać śmieci
see sb home=odprowadzić kogoś do domu
share the housework=dzielić się pracami domowymi
stay in=zostać w domu
stay out=przebywać poza domem
switch on the light=włączyć światło
take the dog for a walk=wyprowadzić psa na spacer
take turns doing sth=robić coś na zmianę
tidy one’s room=posprzątać pokój
vacuum the carpet=odkurzyć dywan
wash clothes=prać ubrania
water the flowers=podlewać kwiaty

[Unit 3 Szkoła]
academy= akademia
college=szkoła wyższa, kolegium
elementary school|primary school=szkoła podstawowa
fee-paying school=płatna szkoła
high school|secondary school=szkoła średnia
independent school=szkoła niepubliczna, społeczna
kindergarten|nursery school=przedszkole
middle school|junior high school=gimnazjum
mixed school|co-educational school=szkoła koedukacyjna
private school=szkoła prywatna
single-sex school=szkoła tylko dla chłopców lub dziewcząt
state school|public school=szkoła państwowa
university=uniwersytet
vocational school=szkoła zawodowa 
Art=plastyka
Biology=biologia
Chemistry=chemia
Civic studies|Civics|Citizenship=wiedza o społeczeństwie
English language and literature=język angielski
foreign languages=języki obce
Geography=geografia
humanities=przedmioty humanistyczne
History=historia
Information and Communication Technology=informatyka
Mathematics/Maths=matematyka
Music=muzyka
Physical Education|PE=wychowanie fizyczne, WF
Physics=fizyka
Polish language and literature=język polski
Religious Education|RE=religia
Science=przedmioty ścisłe, nauki przyrodnicze
subject=przedmiot szkolny 
classmate=kolega z klasy
college student=student 
deputy head|assistant principal=wicedyrektor
examiner=egzaminator
form teacher=wychowawca
headmaster|head teacher|principal=dyrektor
headmistress|head teacher|principal=dyrektorka
lecturer=wykładowca
professor=profesor
schoolboy/pupil=uczeń
schoolgirl/pupil=uczennica
schoolmate=kolega ze szkoły
secretary=sekretarz
student=uczeń, student
teacher=nauczyciel
teaching staff=grono pedagogiczne
university student=student uniwersytetu 
absent from school=nieobecny
active=aktywny
cooperative=chętny do współpracy
uncooperative=niechętny do współpracy
demanding=wymagający
fair=sprawiedliwy
unfair=niesprawiedliwy
gifted=utalentowany
hard-working=pracowity
imaginative=obdarzony wyobraźnią
lazy=leniwy
lenient=pobłażliwy
motivated=zmotywowany
motivating=motywujący
passive=bierny
present at school=obecny
professional=profesjonalny
punctual=punktualny
strict=surowy
systematic=systematyczny
talented=utalentowany
weak=słaby 
blackboard=tablica czarna
board=tablica
calculator=kalkulator
chalk=kreda
copybook/notebook=zeszyt
coursebook/textbook=podręcznik
desk=ławka
duster=gąbka do tablicy
exercise book|workbook=zeszyt ćwiczeń
file=segregator
folder=teczka tekturowa 
interactive whiteboard=tablica interaktywna
locker=szafka
PE kit=strój gimnastyczny
pen=pióro długopis
pencil=ołówek
pencil case=piórnik
pencil sharpener=temperówka
row of desks=rząd ławek
rubber=gumka
ruler=linijka
school bag=tornister, plecak szkolny
whiteboard=tablica biała
whiteboard marker=pisak do tablicy
canteen/dining room=stołówka
classroom=klasa, sala lekcyjna
common room=świetlica
computer room=pracownia komputerowa
corridor=korytarz
gym=sala gimnastyczna
headmaster's office=gabinet dyrektora
laboratory/lab=pracownia
library=biblioteka
office=sekretariat
playground=boisko do zabawy
science lab=sala do nauki biologii, chemii, fizyki
sports field=boisko sportowe
staffroom=pokój nauczycielski
absence=nieobecność
attendance=obecność
break=przerwa
bully=uczeń zastraszający/prześladujący innych uczniów
class=lekcja
club=kółko zainteresowań
competition=olimpida przedmiotowa
compulsory=obowiązkowy
curriculum=program nauczania
deadline=termin wykonania pracy
extracurricular activities=zajęcia pozalekcyjne
grade/mark=ocena, stopień
grant/scholarship=stypendium
holiday=wakacje
learning  difficulties=trudności w n
lesson=lekcja
lunch break=przerwa na lunch
newcomer=nowy uczeń
optional=nieobowiązkowy
school certificate=świadectwo szkolne
school fee=czesne
 school trip=wycieczka szkolna
set books=lektury szkolne
sports club=SKS, Szkolny Klub Sportowy
staff meeting=rada pedagogiczna
strict rules=surowe zasady
term=semestr
timetable=plan lekcji
tutorial=zajęcia w niewielkiej grupie
written work=praca pisemna 
attend=uczęszczać
collaborate=współpracować
chatter=paplać, trajkotać
learn=uczyć się
set=zadawać 
attend a course=uczęszczać na kurs
attend classes=uczęszczać na zajęcia
attend school=uczęszczać do szkoły
discuss set books=omawiać lektury
copy homework=przepisywać od kogoś pracę domową
do a course=robić kurs
do a project=robić projekt
do a task|an activity=wykonywać zadanie
do an exercise=robić ćwiczenie
do an experiment=przeprowadzić eksperyment
do homework=odrabiać pracę domową
do one's best=bardzo się starać
do well dobrze=sobie radzić
expel sb from school=wydalić kogoś ze szkoły
go to school=chodzić do szkoły
hand in homework=oddawać pracę domową
have a break=zrobić sobie przerwę, mieć przerwę
learn a new skill=nabyć nową umiejętność
make a good impression=zrobić dobre wrażenie
make a presentation=zrobić prezentację
make mistakes=robić błędy
make notes=robić notatki
make progress=robić postępy
memorise|learn by heart=uczyć się na pamięć
miss lessons=opuszczać lekcje
participate|take part in a lesson=brać udział w lekcji
pay attention in class=uważać na lekcji
read maps=czytać mapy
set an essay=zadawać wypracowanie
set homework=zadawać pracę domową
skip classes|play truant=opuszczać zajęcia, chodzić na wagary
solve a problem=rozwiązywać zadanie matematyczne
 study hard=uczyć się pilnie
study sources=studiować teksty źródłowe
take the register=sprawdzać listę obecności w dzienniku
turn up late|be late=spóźniać się
wipe the board=ścierać tablicę
work in groups=pracować w grupach 
write an essay=pisać wypracowanie 
academic results=wyniki w nauce
academic standards=poziom nauczania
exam paper=arkusz egzaminacyjny
past exam paper=arkusz egzaminacyjny z ubiegłych lat
exam results=wyniki egzaminu
examination/exam=egzamin
get a place at a university=dostać się na uniwersytet
school-leaving exam=egzamin końcowy
university entrance exam=egzamin wstępny na uczelnię 
cheat in an exam=ściągać na egzaminie
do/sit/take an exam=przystępować do egzaminu
do badly in an exam=źle sobie poradzić na egzaminie
do well in an exam=dobrze sobie poradzić na egzaminie
fail an exam=oblać egzamin
get/score 56 marks in a test=dostać 56 punktów z testu
grade/mark exam papers=sprawdzać arkusze egzaminacyjne
grade/mark a test=sprawdzać test
grade/mark homework=sprawdzać pracę domową
pass an exam=zdać egzamin
prepare for an exam=przygotowywać się do egzaminu
retake an exam=ponownie przystępować do egzaminu
revise for an exam=powtarzać do egzaminu
study for an exam=uczyć się do egzaminu 
BA, Bachelor of Arts=licencjat, nauki humanistyczne
BSc, Bachelor of Science=licencjat, nauki ścisłe
graduate=absolwent
MA, Master of Arts=magister, nauki humanistyczne
MSc, Master of Science=magister, nauki ścisłe
PhD, Doctor of Philosophy=doktor, nauki humanistyczne i ścisłe 
get into university=dostać się na uczelnię
graduate from university=skończyć uniwersytet
receive/obtain/get a certificate=otrzymać świadectwo
receive/obtain/get a degree=uzyskać stopień naukowy
receive/obtain/get a diploma=otrzymać dyplom

[Unit 4 Praca]
accountant=księgowy
architect=architekt
personal assistant=asystent/asystentka
beautician=kosmetyczka
builder=budowniczy
bus driver=kierowca autobusu
busboy=pomocnik kelnera
car mechanic=mechanik samochodowy
career advisor=doradca zawodowy
carpenter=stolarz
chef=szef kuchni
chemist/pharmacist=farmaceuta
cleaner=sprzątacz/ sprzątaczka
computer programmer=programista
cook=kucharz
dentist=dentysta
doctor=lekarz
dressmaker=krawiec
driving instructor=instruktor nauki jazdy
dustman=śmieciarz
economist=ekonomista
electrician=elektryk
engineer=inżynier
executive=pracownik na kierowniczym stanowisku
farmer=rolnik
fashion designer=projektant mody
film director=reżyser
firefighter=strażak
flight attendant=steward/stewardesa
hairdresser=fryzjer
housewife=gospodyni domowa
instructor=instruktor
interior designer=projektant wnętrz
IT specialist=informatyk
journalist=dziennikarz
lawyer=prawnik
lecturer=wykładowca
librarian=bibliotekarz
lollipop lady=pani przeprowadzająca przez ulicę dzieci idące do szkoły 
lollipop man=pan przeprowadzający przez ulicę dzieci idące do szkoły
lorry driver=kierowca ciężarówki
manager=menedżer, kierownik
miner=górnik
musician=muzyk
nurse=pielęgniarz/ pielęgniarka
painter=malarz
photographer=fotograf
pilot=pilot
plumber=hydraulik
police officer=policjant
politician=polityk
postman=listonosz
postwoman=listonoszka
psychologist=psycholog
receptionist=recepcjonista
sailor=żeglarz
sales representative|sales rep=przedstawiciel handlowy
scientist=naukowiec
secretary=sekretarz/sekretarka
security guard=pracownik ochrony
shop assistant=sprzedawca
shopkeeper=sklepikarz
stockbroker=makler giełdowy
surgeon=chirurg
tailor=krawiec męski
taxi driver=taksówkarz
teacher=nauczyciel
ticket inspector=kontroler biletów
translator=tłumacz
travel agent=agent biura podróży
TV presenter=prezenter telewizyjny
vet=weterynarz
waiter=kelner
waitress=kelnerka 
badly paid=źle płatny
full-time=pełnoetatowy
manual=fizyczny
monotonous=monotonny
part-time=w niepełnym wymiarze godzin
permanent=stały
satisfying=satysfakcjonujący 
stressful=stresujący
temporary=tymczasowy
well-paid=dobrze płatny 
applicant=osoba starająca się o pracę
candidate=kandydat
suitable candidate=odpowiedni kandydat
work contract=umowa o pracę, kontrakt
curriculum vitae|CV=życiorys, CV
employment contract=umowa o pracę
experience=doświadczenie
five years' experiwnce=pięcioletnie doświadczenie
previous experience=dotychczasowe doświadczenie
work experoence=doświadczenie zawodowe
form=formularz
application=formularz podania o pracę
interwiew=rozmowa kwalifikacyjna
interviewer=osoba przeprowadzająca rozmowę kwalifikacyjną
job=zawód, praca
current job=obecna praca
job advertisement=ogłoszenie o pracę
job application=podanie o pracę
job centre=biuro pośrednictwa pracy
job interwiew=rozmowa kwalifikacyjna
odd jobs=różnorodne, drobne prace na zlecenie
letter of reference=list referencyjny
occupation=zawód
opportunity=okazja, szansa
personal details=dane osobowe
position/post=stanowisko, posada
profession=zawód wymagający kwalifikacji
by profession=z zawodu
qualifications=kwalifikacje
recruitment=rekrutacja
skills=umiejętności
administrative skills=umiejętności administracyjne
communication skills=umiejętności komunikacyjne
computerskills|IT skills=umiejętność obsługi komputera
language skills=znajomość języka
rganisational skills=umiejętności organizacyjne
training=szkolenie
training session=sesja szkoleniowa
vacancy=wolna posada, wakat
advertise=ogłaszać
recruit=rekrutować 
apply for a job=złożyć podanie o pracę
apply for a position=ubiegać się stanowisko
enclose|attach a CV=załączyć życiorys
fill in a form=wypełnić formularz
find a job/work=znaleźć pracę
interwiew applicants=przeprowadzać rozmowę kwalifikacyjną z kandydatami
look for a job=szukać pracy
sign a work contract=podpisać umowę o pracę
the job involves dealing with people=praca wymaga kontaktów z ludźmi 
bonus=premia
annual bonus=roczna premia
earnings=zarobki
fee=wynagrodzenie za usługi
fringe benefits/perks=świadczenia dodatkowe
income=dochód
minimum wage=płaca minimalna
pay=płaca
decent pay=przyzwoita płaca
pay rise=podwyżka wynagrodzenia
reasonable pay=rozsądna płaca
sick pay=wynagrodzenie za czas choroby
pension=emerytura, pieniądze
profit=zysk
salary=pensja
starting salary=pensja początkowa
competitive salary=konkurencyjne wynagrodzenie
tax=podatek
tip=napiwek
wages=płaca tygodniowa, dzienna lub godzinowa
earn=zarabiać
pay=płacić 
get a pay rise=dostać podwyżkę
get paid=otrzymać wypłatę
get paid overtime=otrzymać wynagrodzenie za pracę w nadgodzinach 
boss=szef
chief executive officer, CEO=dyrektor generalny
colleague/workmate=kolega z pracy
employee=pracownik
employer=pracodawca
staff=personel
support=pracownicy obsługi technicznej
team=zespół
team worker=członek zespołu
worker=pracownik fizyczny
factory worker=pracownik fabryki 
career=kariera zawodowa
prospects=perspektywy rozwoju zawodowego
company=firma, przedsiębiorstwo
deadline=termin wykonania zadania/pracy
employment=zatrudnienie
hard work=ciężka praca
management=zarządzanie
office=biuro
overwork=przepracowanie
service sector=sektor usług
teamwork=praca zespołowa
trade union=związek zawodowy
working conditions=warunki pracy
workplace=miejsce pracy 
assist sb=pomagać, asystować komuś
employ=zatrudniać
manage=zarządzać
work=pracować 
be at work=być w pracy
be good at sth=być w czymś dobrym
be in charge of sth=kierować czymś, być za coś odpowiedzialnym
be on duty być=na dyżurze
be on strike=strajkować
be open for business=być czynnym 
be part of a team=być częścią zespołu
be punctual=być punktualnym
be qualified=być wykwalifikowanym
be responsible for sb/sth=być odpowiedzialnym za kogoś/coś
be self-employed=prowadzić działalność gospodarczą, pracować na własny rachunek
be/get promoted=awansować
clock in/on=odbić kartę zegarową, przychodząc do pracy
deal with people=pracować z ludźmi
do a hard day's work=pracować ciężko cały dzień
do a training course=brać udział w szkoleniu
do/take one's job well=wykonywać dobrze swoją pracę
do physical work=pracować fizycznie
do sth for a living/earn a living=zarabiać na życie
do/work overtime=pracować w nadgodzinach
get a job=dostać pracę
give sb a hand=pomagać komuś
go on strike=rozpocząć strajk
go to work iść=do pracy
pay per hour=płacić za godzinę pracy
pay per month=płacić za miesiąc pracy
pay per week=płacić za tydzień pracy
run one's own business=prowadzić własną firmę
start one's own business=założyć własną firmę
take over duties from sb=przejmować od kogoś obowiązki
work well in a team=dobrze pracować w zespole
work as an engineer=pracować jako inżynier
work for a company/person=pracować w firmie/dla kogoś
work from home=pracować z domu
work hard=ciężko pracować
work long hours=pracować wiele godzin dziennie
work on one's own=pracować samodzielnie
work on sth=pracować nad czymś
work/do shifts=pracować na zmiany
work to deadlines=pracować z zachowaniem terminów
work under pressure=pracować pod presją
work with someone=pracować z kimś lub pod czyimś kierunkiem 
holiday=urlop
bank holiday=dzień wolny od pracy, święto
leave=urlop, zwolnienie
maternity leave=urlop macierzyński
paid leave=urlop płatny
sick leave=zwolnienie lekarskie 
be off sick=być na zwolnieniu lekarskim 
be on holiday=być na urlopie
take a week's leave=wziąć tydzień urlopu
take a day off work=wziąć dzień wolny 
economic crisis=kryzys gospodarczy
job losses=zlikwidowane miejsca pracy
pensioner=emeryt
retirement=emerytura, okres w zyciu człowieka
early retirement=wcześniejsza emerytura
unemployed|out of work=bezrobotny
unemployment=bezrobocie
high unemployment=wysokie bezrobocie
low unemployment=niskie bezrobocie
benefit=zasiłek dla bezrobotnych 
resign=złożyć rezygnację
retire=odejść na emeryturę 
be on the dole=być na zasiłku dla bezrobotnych
close down a company/store=zamknąć firmę/sklep
fire sb/Iet sb go/sack sb/give sb the sack=zwolnić kogoś z pracy
give up one's job/quit one's job=rzucić pracę
go bankrupt=zbankrutować
hand in one's resignation=złożyć rezygnację
leave a job=odejść z pracy
lose one's job=stracić pracę
make sb redundant=zwolnić kogoś z powodu redukcji etatów 
au pair=au pair
babysitter=opiekun / opiekunka do dziecka
fruit picking=zbieranie owoców
fruit picker=osoba zbierająca owoce
holiday/summer job=praca wakacyjna
Iifeguard=ratownik / ratowniczka
pizza delivery=dostawa pizzy
seasonal work=praca sezonowa
summer camp supervisor=kierownik obozu wakacyjnego
tour guide=przewodnik
voluntary work=wolontariat 

[Unit 5 Życie towarzyskie i rodzinne]
adopted child=adoptowane dziecko
adoption=adopcja
aunt=ciocia
brother=brat
brother-in-law=szwagier
child=dziecko
children=dzieci
cousin=kuzyn
daughter=córka
daughter-in-law=synowa
ex-husband=były mąż
ex-wife=była żona
family member=członek rodziny
family tree=drzewo genealogiczne
father=ojciec
father-in-law=teść
foster children=przybrane dzieci
foster parents=przybrani rodzice
grandchildren=wnuki
granddaughter=wnuczka
grandfather=dziadek
grandmother=babcia
grandparents=dziadkowie
grandson=wnuk
great-grandchildren=prawnuki
great-granddaughter=prawnuczka
great-grandfather=pradziadek
great-grandmother=prababcia
great-grandparents=pradziadkowie
great-grandson=prawnuk
half-brother=brat przyrodni
half-sister=siostra przyrodnia
husband=mąż
mother=matka
mother-in-law=teściowa
nephew=siostrzeniec, bratanek 
niece=siostrzenica, bratanica
only child=jedynak
orphan=sierota
parents=rodzice
relative=krewny
siblings=rodzeństwo
single father=ojciec samotnie wychowujący dziecko
single mother=matka samotnie wychowująca dziecko
sister=siostra
sister-in-law=szwagierka, bratowa
son=syn
son-in-law=zięć
stepbrother=syn ojczyma lub macochy
stepdaughter=pasierbica
stepfather=ojczym
stepmother=macocha
stepsister=córka ojczyma lub macochy
stepson=pasierb
twins=bliźniaki
uncle=wujek
widow=wdowa
widower=wdowiec
wife=żona 
anniversary=rocznica
birthday=urodziny
birthday cake=tort urodzinowy
birthday present=prezent urodzinowy
Christmas=Boże Narodzenie
Christmas card=kartka bożonarodzeniowa
Christmas Eve=wigilia
Easter=Wielkanoc
family gathering=spotkanie rodzinne
Father's Day=Dzień Ojca
festival=festiwal, święto
funeral=pogrzeb 
gift/present=prezent
Mother's Day=Dzień Matki
New Year's Day=Nowy Rok
New Year's Eve=Sylwester
Valentine's Day=Walentynki
wedding=ślub
wedding reception=przyjęcie weselne 
celebrate=świętować 
blow out candles=zdmuchiwać świeczki
celebrate sb's birthday=obchodzić czyjeś urodziny
decorate the Christmas tree=ubierać choinkę
dress up as=przebrać się za
have a celebration=świętować
paint eggs=malować jajka
unwrap a present=odpakować prezent 
adolescence=okres dorastania
adolescent=dorastający chłopak/ dorastająca dziewczyna
adult=dorosły
adulthood=wiek dorosły
age group=grupa wiekowa
at the age of thirty=w wieku trzydziestu lat
birth=narodziny
childhood=dzieciństwo
dead=umarły
death=śmierć
generation=pokolenie
grown-up=dorosły
middle age=wiek średni
middle-aged= w średnim wieku
old age=starość
youth=młodość 
die=umrzeć
be born=urodzić się
grow up=dorastać
divorce=rozwód
divorce|get a divorce=rozwieść się
divorced=rozwiedziony, rozwiedziona
engaged=zaręczony, zaręczona
engagement ring=pierścionek zaręczynowy
honeymoon=miesiąc miodowy
marriage=małżeństwo
married to sb=żonaty/zamężna z kimś
married couple=małżeństwo
pregnant=w ciąży
quality time=czas przeznaczony dla rodziny
single=stanu wolnego 
be a strict parent=być surowym rodzicem
be expecting a child=spodziewać się dziecka
become/get engaged=zaręczyć się
bring up children|raise children=wychowywać dzieci
care for somebody=troszczyć się o kogoś
get married to sb|marry sb=poślubić kogoś
give birth to a child|have a baby=urodzić dziecko
look after children|take care of children=opiekować się dziećmi
look alike=wyglądać podobnie
propose marriage=oświadczyć się
run away from home=uciec z domu
tell somebody off=ganić kogoś
babysit=opiekować się dzieckiem kogoś innego
dress=ubierać się
lie=leżeć
undress=rozbierać się 
daily routine=ustalony porządek dnia
eat out=jeść poza domem
get dressed=ubierać się
get ready for bed/school=szykować się do snu/szkoły
get up=wstawać 
go to bed early/late=kłaść się spać wcześnie/późno
go to school=iść do szkoły
go to work=iść do pracy
have a meal=zjeść posiłek
have breakfast=jeść śniadanie
have dinner=jeść obiad
have lunch=jeść lunch
have supper=jeść kolację
have tea=jeść podwieczorek
have/take a bath=brać kąpiel
have/take a rest=odpoczywać
have/take a shower=brać prysznic
lie down=położyć się
lie in=wylegiwać się
make one's bed=posłać łóżko
prepare a meal=przygotowywać posiłek
sweep the floor=zamiatać podłogę
take a nap=zdrzemnąć się
take the children to school=zaprowadzić/zawieźć dzieci do szkoły
take the dog for a walk=wyprowadzić psa na spacer
take turns to do sth=wykonywać coś na zmianę
tidy up one's room=posprzątać swój pokój
wake up=budzić się 
ball=bal
entertainment=rozrywka
free time=czas wolny
leisure activities=zajęcia w czasie wolnym
party=impreza
dance party=potańcówka
fancy-dress party=bal kostiumowy
house party=impreza w domu, domówka
weekend plans=plany na weekend 
dance=tańczyć
play= grać 
ask sb out=umówić się z kimś na randkę
dress up=ubierać się elegancko
go bowling=iść na kręgle
go clubbing=iść do klubu/klubów
go dancing=iść potańczyć
go for a walk=iść na spacer
go out=wychodzić z domu 
go out for a meal=iść do restauracji
go swimming=iść popływać
go to a concert=iść na koncert
go to a disco=iść na dyskotekę
go to a party=iść na przyjęcie
go to the cinema=iść do kina
hang out=with friends spędzać czas z przyjaciółmi
have a party=wydawać przyjęcie
listen to music | listen to the radio=słuchać muzyki/radia
look forward to sth=z niecierpliwością czekać na coś
meet friends=spotykać się z przyjaciółmi
pass time=spędzać czas
play board games=grać w gry planszowe
play cards=grać w karty
play chess=grać w szachy
play computer games=grać w gry komputerowe
play the guitar=grać na gitarze
play the piano=grać na fortepianie/pianinie
play video games=grać w gry wideo
read aloud to sb=czytać komuś na głos
read books/comics/magazines=czytać książki/komiksy/ czasopisma
spend time outdoors=spędzać czas na świeżym powietrzu
spend time together=spędzać czas razem
watch a film/video/TV=oglądać film/wideo/telewizję 
acquaintance=znajomy
boyfriend=chłopak, sympatia
circle of friends=grono przyjaciół
close friend=bliski przyjaciel
colleague=kolega z pracy
fiance=narzeczony
fiancee=narzeczona
friend=przyjaciel, przyjaciółka
family friend=przyjaciel rodziny
girlfriend=dziewczyna, sympatia
lovebirds=zakochani,
mate=kumpel, kumpelka 
be attracted to sb=czuć pociąg do kogoś
be in love=być zakochanym 
be ready for a serious relationship=być gotowym na poważny związek
go out with sb=chodzić z kimś, umawiać się z kimś na randki
love somebody=kochać kogoś
make new friends=zawierać nowe przyjaźnie
start a relationship with sb=wejść z kimś w związek
be grounded=mieć szlaban na wyjścia
break up with sb|split up with sb=zerwać z kimś
cross boundaries=przekraczać granice
end a relationship with sb=zakończyć z kimś związek
enjoy oneself|have fun|have a good time=dobrze się bawić
fall out|have a row|have an argument|quarrel with sb=pokłócić się z kimś
family values=wartości rodzinne
generation gap=konflikt pokoleń
get divorced=rozwieść się
get on well with sb=być z kimś w dobrych stosunkach
get the shock of one's life=doznać ogromnego szoku
get together with sb=spotykać się z kimś
ground sb=dać szlaban na wyjścia
have a bad relationship with sb=być z kimś w złych stosunkach
make up with sb=pogodzić się z kimś
push the limits=przesuwać granice
run away from home=uciekać z domu
set boundaries=ustalać granice
talk sth through=omówić coś

[Unit 6 Żywienie]
bread=chleb
brown bread=ciemny chleb
white bread=biały chleb
wholemeal bread=chleb razowy
breakfast cereal=płatki śniadaniowe
cereal products=produkty zbożowe
cornflakes= produkty zbożowe
bread=chleb
brown bread=ciemny chleb
fried bread=smażony chleb
white bread=biały chleb
wholemeal bread=chleb razowy
breakfast cereal=płatki śniadaniowe
cereal products=produkty zbożowe
croissant=rogalik
cornflakes=płatki kukurydziane
muesli=muesli
noodles/pasta=makaron
rice=ryż
roll=bułka
toast=pieczywo tostowe
butter=masło
cheese=ser
blue cheese=ser pleśniowy
cottage cheese=twarożek
grated cheese=starty ser
parmesan cheese=parmezan
cream=śmietana
dairy products=nabiał
egg=jajko
margarine=margaryna
milkshake=koktajl mleczny
yoghurt=jogurt
bacon=bekon
beef=wołowina
chicken=kurczak
ham=szynka
horsemeat=konina
meat=mięso
pork=wieprzowina
sausage=kiełbasa
turkey=indyk
anchovy=anchois
cod=dorsz
fillet=filet
fish=ryba
fish paste=pasta rybna
herring=śledź
prawn=krewetka
salmon=łosoś
sardine=sardynka
seafood=owoce morza
shellfish=skorupiaki
tuna=tuńczyk
apple=jabłko
apricot=morela
avocado=awokado
banana=banan
blackcurrant=czarna porzeczka
blueberry=jagoda
cherry=wiśnia
coconut=kokos
fruit=owoce
grapefruit=grejpfrut
grapes=winogrona
kiwi fruit=kiwi
lemon=cytryna
lime=limonka
mango=mango
melon=melon
orange=pomarańcza
peach=brzoskiwnia
pear=gruszka
pineapple=ananas
plum=śliwka
strawberry=truskawka
watermelon=arbuz
anchovy=anchois
asparagus=szparag
aubergine=bakłażan
beans=fasola
broccoli=brokuły
cabbage=kapusta
carrot=marchewka
cauliflower=kalafior
celery=seler
chilli=chilly
cucumber=ogórek
garlic=czosnek
green peas=groszek
kohlrabi=kalarepa
lettuce=sałata
maize=kukurydza
mushroom=grzyb
onion=cebula
parsley=pietruszka
pepper=papryka
green pepper=zielona papryka
red pepper=czerwona papryka
potato=ziemniak
radish=rzodkiewka
spinach=szpinak
sweetcorn=kukurydza cukrowa
tomato=pomidor
vegetable=warzywo
apple pie=szarlotka, jabłecznik
biscuit/cookie=herbatnik, ciasteczko
cake=ciasto, ciastko, tort
cheesecake=sernik
chocolate=czekolada, czekoladka
crisps=chipsy
dessert=deser
fruitcake=ciasto z suszonymi owocami
honey=miód
pudding=deser
sweets=słodycze
basil=bazylia
custard=słodki sos
fat=tłuszcz
herbs=zioła
ketchup=ketchup
jam=dżem
marmelade=marmolada
mayonnaise=majonez
mustard=musztarda
olive oil=oliwa
pepper=pieprz
black pepper=czarny pieprz
salad dressing=sos do sałatek
salt=sól
a pinch of salt=szczypta soli
sauce=sos
spice=przyprawa
sugar=cukier
barbecue sauce=sos barbecue
sweet and sour sauce=sos słodko-kwaśny
tomato sauce=sos pomidorowy
vinegar=ocet
beer=piwo
cocoa=kakao
coffee=kawa
freshly brewed coffee=świeżo parzona kawa
cola=cola
drink=napój
fizzy drink=napój gazowany
soft drink=napój bezalkoholowy
juice=sok
freshly-squeezed juice=świeżo wyciśnięty sok
tea=herbata
smoothie=koktajl owocowy
water=woda
tap water=woda z kranu
wine=wino
baked beans=fasolka w sosie pomidorowym
black pudding=kaszanka
burger=hamburger
chicken nuggets=kawałki kurczaka
chicken wings=skrzydełka z kurczaka
curry=curry
hotdog=hotdog
kebab=kebab
lasagne=lasagne
fish and chips=ryba z frytkami
mashed potatoes=tłuczone ziemniaki
omelette=omlet
pancake=naleśnik
pork rib=żeberko wieprzowe
salad=sałatka
sandwich=kanapka
soup=zupa
spring roll=sajgonka
steak=stek
stwew=gulasz
tortilla=tortilla
sweet and sour chicken=kurczak w sosie słodko-kwaśnym
crunchy=chrupki, chrupiący
delicious=pyszny
disgusting=ohudny
dry=wytrawny
easy-to-spread=łatwy do rozsmarowania
fatty=tłusty
fresh=świeży
fizzy=musujący
hot=ostry
juicy=soczysty
lean=chude mięso
medium=średnio wysmażony
mild=łagodny
nutritious=pożywny, odżywczy
rare=niedosmażony
raw=surowy
smelly=śmierdzący
smoked=wędzony
sour=kwaśny
sparkling=gazowany
spicy=pikantny
stale=czerstwy
still=niegazowany
strong=mocny
sweet=słodki
tasty=smaczny
weak=słaby
well-done=dobrze wysmażony
yummy=pyszny, "pycha"
bowl=miska
finely chopped=drobno posiekany
frying pan=patelnia
ingredient=składnik
kettle=czajnik
leftovers=resztki
oven=piekarnik
pan=rondel
pot=garnek
recipe=przepis
saucepan=rondelek
slice=plasterek
spoonful=łyżeczka,ilość
tablespoonful=łyżka stołowa, ilość
tin opener=otwieracz do puszek
afternoon tea=podwieczorek
barbecue=grill
breakfast=śniadanie
course=danie, część posiłku
dinner=obiad
dish=danie, potrawa
lunch=lunch
meal=posiłek
packed lunch=drugie śniadanie
picnic=piknik
snack=przekąska
light snack=lekka przekąska
supper=kolacja
takeway=posiłek na wynos 
cutlery=sztućce
eggcup=kieliszek do jajek
fork=widelec
glass=szklanka, kieliszek
knife=nóż
napkin/serviette=serwetka
plate=talerz
soup bowl=talerz do zupy
spoon=łyżka 
add=dodawać
bake=piec chleb, ciasto
barbecue=grillować, piec coś na grillu
beat=ubijać
boil=zagotować do wrzenia, wrzeć
chop=siekać
cook=gotować
cut=kroić
freeze=zamrażać
fry=smażyć
grate=zetrzeć na tarce
grill=grillować, piec coś na grillu w kuchni
heat=zagrzać, rozgrzać
melt=rozpuszczać, topić
mix=mieszać kilka składników
overcook=rozgotować, gotować zbyt długo
peel=obierać
pour=nalewać
rise=rosnąć
roast=piec mięso
season=doprawić
slice=kroić na plasterki
stir=mieszać 
be thirsty=być spragnionym
brew tea/coffee=zaparzać herbatę/kawę
clear the table=sprzątać ze stołu
cook a meal=ugotować posiłek
do the washing-up/wash up=myć naczynia
grab a coffee=wypić szybko kawę
grab a bite to eat=przekąsić coś
have a meal=jeść posiłek
prepare a meal=przygotowywać posiłek
put sth on=nastawić coś
roll up=zawijać
set/lay the table=nakryć do stołu
top sth with sth=posypać coś czymś 
calorie=kaloria
diet=dieta
vegetarian diet=dieta wegetariańska
fattening=tuczący
non-fattening=nietuczący
healthy=zdrowy
mineral=minerał
vegetarian food=jedzenie wegetariańskie
vitamin=witamina
weight=waga 
be fussy=grymasić
be on a diet=być na diecie
eat junk food=jeść niezdrowe jedzenie
go on a diet=rozpocząć dietę
have a sweet tooth=mieć słabość do słodyczy
have an appetite=mieć apetyt 
high in sth=o wysokiej zawartości czegoś
keep one's weight down=utrzymywać niską wagę
lose weight=tracić na wadze
low in sth=o niskiej zawartości czegoś
put on weight=przybierać na wadze
skip breakfast=nie jeść śniadania
starve=głodować, umierać z głodu
throw up=wymiotować
watch one's weight=pilnować wagi
all-you-can-eat restaurant/buffet=restauracja, w której po zapłaceniu określonej kwoty można zjeść dowolną ilość
bill=rachunek
buffet breakfast=śniadanie w formie stołu szwedzkiego
buffet car=wagon restauracyjny
cafe=kawiarnia
canteen/cafeteria=stołówka
diner=restauracja
fast food restaurant=bar szybkiej obsługi
main course=danie główne
menu=karta dań
order=zamówienie
pub=pub
self-service restaurant=reastauracja samoobsługowa
service=obsługa
speciality=specjalność
starter=przystawka
tablecloth=obrus
takeaway=restauracja sprzedająca jedzenie na wynos
tip=napiwek
waiter=kelner
waitress=kelnerka
wine list=karta win 
order=zamówić
serve=obsługiwać, podawać 
book a table=zarezerwować stolik
eat out=jeść poza domem
enjoy your meal=smacznego
leave a tip=zostawić napiwek
mix up orders=pomylić zamówienia 

[Unit 7 Zakupy i usługi]
antique shop=sklep z antykami
baker's/bakery=piekarnia
bookshop=księgarnia
boutique=butik
butcher's=sklep mięsny
chain store=sklep należący do sieci handlowej
charity shop=sklep z rzeczami używanymi, którego dochód przeznaczony jest na cele dobroczynne
chemist's/pharmacy=apteka
clothes shop=sklep odzieżowy
delicatessen=delikatesy
department store=dom towarowy
DIY store=sklep budowlany, sklep z materiałami do wykonywania remontów
fashion boutique=butik z modnymi ubraniami
fishmonger's=sklep rybny
florist's|flower shop=kwiaciarnia
furniture shop=sklep meblowy
garden centre=sklep ogrodniczy
greengrocer's|fruit and veg shop=warzywniak
hardware shop=sklep z artykułami metalowymi
health food shop=sklep ze zdrową żywnością
the High Street=główna ulica handlowa
independent shop=sklep nienależący do sieci handlowej
jeweller's=jubiler
market=rynek, targ
farmers'=targ, na którym handlują okoliczni rolnicy
music shop=sklep muzyczny
newsagent's=kiosk z gazetami
off-licence=sklep z alkoholem
pet shop=sklep z artykułami dla zwierząt 
retail park=centrum handlowe za miastem
second-hand shop=sklep z używanymi rzeczami
shoe shop=sklep obuwniczy
shopping centre|shopping mail=centrum handlowe
sports shop=sklep sportowy
stationer's=sklep papierniczy
supermarket=supermarket
toy shop=sklep z zabawkami 
aisle=alejka między regałami
baby changing facilities=pokój matki z dzieckiem
bar code=kod kreskowy
basket=koszyk
brand-new=nowiutki, fabrycznie nowy
cheap=tani
checkout assistant|cashier=kasjer
checkout/till=kasa w sklepie
choice=wybór
convenience food=gotowe potrawy
conveyor belt=taśma przy kasie
counter=lada, kontuar
customer=klient
department=dział
entrance=wejście
escalator=schody ruchome
expensive=drogi
food hall=dział spożywczy
for sale=na sprzedaż
frozen foods section=dział mrożonek
level=poziom
lift=winda
meeting point=miejsce spotkań
on sale=w sprzedaży
pet food=karma dla zwierząt
price tag=metka z ceną 
queue=kolejka
range of products=gama produktów
second-hand=używany
self-service checkout=kasa samoobługowa
shelf=półka
shop assistant=sprzedawca
shopaholic=osoba uzależniona od zakupów
shopper=osoba robiąca zakupy
shopping bag=torba na zakupy
shopping list=lista zakupów
stall=stragan
tinned food=konserwy
toiletries=artykuły higieniczne
toilets=toalety
trolley=wózek na zakupy
underground car park=parking podziemny 
purchase=zakupić, nabyć
queue up=stać w kolejce 
Can I help you?=Czym mogę służyć?
pick a product off a shelf=wybrać produkt z półki sklepowej
shop online=kupować przez internet
stand in line=stać w kolejce
changing/fitting room=przymierzalnia
designer clothes=markowe ubrania
fashion=moda
fashion accessories=modne dodatki
fashion label=znana marka ubrań, producent modnych ubrań
the latest fashions intin= najnowsza moda
fashionable=modny
label=metka
designer label=znana marka ubrań
last year's model=model z ubiegłego roku
men's wear=moda męska
outfit=strój 
size=rozmiar
the right size=odpowiedni rozmiar
too loose=za luźny
too small=za mały
too tight=za ciasny
trendy=modny, na topie
women's wear=moda damska 
fit=pasować pod względem rozmiaru
gift-wrap=zapakować na prezent
match=pasować pod względem koloru, wzoru
suit=pasować do osoby, jej stylu
go round the shops=chodzić po sklepach
go shopping=iść na zakupy
I'm size 38=noszę rozmiar 38
look for sth szukać=czegoś
shop for clothes=kupować ubrania
try sth on=przymierzać coś 
50 percent discount/off=pięćdziesiąt procent zniżki
bargain=okazja, produkt w niskiej cenie
deal=okazja, dobry interes
great reductions=znaczne obniżki cen
price=cena
fair price=uczciwa cena
half price=za pół ceny
low price=niska cena
sale=wyprzedaż
special offer=oferta specjalna
on special offer=w ofercie specjalnej 
be reduced from 100 pounds to 50 pounds=być przecenionym ze 100 funtów na 50 funtów
buy sth at a discount=kupić coś ze zniżką
buy sth in=a sale kupić coś na wyprzedaży
buy two, get one free=jeśli kupisz dwa, jeden dostaniesz gratis 
beauty salon=salon piękności
car wash=myjnia samochodowa
daycare centre for children=punkt opieki nad dziećmi, przedszkole, żłobek
dry cleaner's=pralnia chemiczna 
eatery=knajpka, mała restauracja
food court=miejsce w centrum handlowym, gdzie znajdują się restauracje
garage=warsztat samochodowy
hairdresser's=fryzjer
in-store cafe=kawiarnia w sklepie
launderette=pralnia samoobsługowa
laundry=pralnia
multi-screen cinema=multipleks
petrol station=stacja benzynowa
photographer's=fotograf
post office=poczta
service station=stacja obsługi pojazdów
services=usługi
shoe repairs=naprawa obuwia 
account number=numer konta
bank=bank
branch of a bank=oddział banku
bank account=konto bankowe
exchange rate=kurs wymiany walut
insurance=ubezpiecznie
interest rate=stopa procentowa 
borrow money=pożyczać pieniądze od kogoś
change money=wymienić pieniądze
get into debt=popaść w długi
invest in stocks and shares=inwestować w akcje
lend money=pożyczać pieniądze komuś
open an account=otwierać konto
pay off a loan=spłacać pożyczkę
put money in a bank=wpłacić pieniądze na konto bankowe
take out a loan=wziąć pożyczkę
take out money=wypłacić pienądze
transfer money=przelewać pieniądze 
ATM|automatic teller machine|cash machine|cashpoint=bankomat
bank transfer=przelew bankowy
banknote/note=banknot
cash=gotówka
change=reszta, drobne 
cheque=czek
coin=moneta
credit card=karta kredytowa
debit card=karta debetowa 
haggle=targować się
pay=płacić 
accept/take credit cards=honorować karty kredytowe
be broke=być spłukanym
cost a bomb=kosztować fortunę enter
your PIN=wprowadzić numer PIN
get money out of a cash machine=wypłacić pieniądze z bankomatu
not have enough cash on oneself=nie mieć przy sobie wystarczającej ilości gotówki
pay by bank transfer=płacić przelewem
pay by cheque=płacić czekiem
pay by credit card=płacić kartą
pay in cash=płacić gotówką
save money=oszczędzać pieniądze
spend a fortune/money on sth=wydać fortunę/pieniądze na coś 
broken=zepsuty
chipped=wyszczerbiony
complaint=reklamacja
cracked=pęknięty
dissatisfied=niezadowolony
faulty=wadliwy, mający usterki
past the sell-by date=po dacie przydatności, przeterminowany
receipt=paragon
replacement=produkt na wymianę
return=zwrot
rip-off=zdzierstwo, złodziejstwo
scratched=porysowany
stain=plama
torn=rozdarty 
exchange=wymienić
replace=wymienić
work=działać 
get a refund|get your money back=otrzymać zwrot pieniędzy
give refunds=zwracać pieniądze
keep crashing=ciągle się zawieszać, psuć
make a complaint=złożyć reklamację 
return/take sth back=zwrócić, oddać coś do sklepu
talk to the manager=porozmawiać z kierownikiem sklepu 
ad/advert/advertisement=reklama
advertising campaign=kampania reklamowa
billboard/hoarding=billboard
brand/make=marka
brand name=nazwa handlowa
brochure=broszura reklamowa
classified ad=ogłoszenie drobne
commercial=reklama telewizyjna / radiowa
jingle=melodyjka reklamowa
leaflet=ulotka reklamowa
logo=logo
peer pressure=presja grupy rówieśniczej
poster=plakat
slogan=hasło reklamowe 
advertise=reklamować 
attract the crowds=przyciągać tłumy
place an advertisement=zamieścić ogłoszenie 
consumer=konsument
consumer society=społeczeństwo konsumpcyjne
consumerism=konsumpcjonizm
consumption=konsumpcja
free market=wolny rynek
goods=towary
product=produkt
profit=profit / zysk
protectionism=protekcjonizm
trade=handel 

[Unit 8 Podróżowanie i turystyka]
bicycle/bike=rower
boat=łódź
bus=autobus
coach=autokar
double decker bus=autobus piętrowy
ferry=prom
lorry/truck=ciężarówka
means of transport=środek transportu
minibus=mikrobus
motorbike/motorcycle=motocykl
plane=samolot
taxi/cab=taksówka
train=pociąg
underground/subway=metro
van=furgonetka
yacht=jacht 
arrival=przylot, przybycie
backpack/rucksack=plecak
baggage/Iuggage=bagaż
business trip=podróż służbowa, delegacja
cancellation=odwołanie
commuter=osoba, która codziennie dojeżdża do pracy
delay=opóźnienie
delayed=opóźniony
departure=odlot, odjazd
destination=docelowy punkt podróży
expedition=ekspedycja
explorer=badacz, podróżnik
excursion=wycieczka
fare=opłata za przejazd, cena biletu
journey/trip=podróż
left luggage office=przechowalnia bagażu
luggage trolley=wózek bagażowy
on board=na pokładzie
pass=bilet upoważniający do wielokrotnego przejazdu
passenger=pasażer
suitcase=walizka
ticket=bilet
first class ticket=bilet pierwszej klasy 
monthly ticket=bilet miesięczny
return ticket=bilet powrotny
second class ticket=bilet drugiej klasy
single ticket=bilet w jedną stronę
ticket office=kasa biletowa
timetable=rozkład jazdy
travelling companion=towarzysz podróży
urban transport=komunikacja miejska 
accelerate=przyśpieszać
arrive=przylatywać, przybyć
board=wchodzić na pokład
book=rezerwować
brake=hamować
catch=złapać, zdążyć na
change=przesiadać się
commute=dojeżdżać do pracy
depart=odlatywać, odjeżdżać
drive=prowadzić samochód
fine=ukarać mandatem
hitchhike=podróżować autostopem
land=lądować
miss=spóźnić się na
overtake=wyprzedzać
sail=płynąć, żeglować
steer=kierować, sterować
travel=podróżować, jechać 
arrive at the station=przybyć na stację
arrive in New York=przybyć do Nowego Jorku
ask the way=zapytać o drogę
be on one's way=być w drodze
be/get stuck in a trafiic jam=utknąć w korku
board a ferry wchodzić=na pokład promu
board a piane=wchodzić na pokład samolotu
board a ship/boat=wchodzić na pokład statku/łodzi
book a flight=rezerwować lot
book a room=rezerwować pokój
book a seat=rezerwować miejsce
book a ticket=rezerwować bilet
book oniine=rezerwować przez internet
break down=popsuć się
catch a bus=złapać autobus 
catch a flight=złapać lot
change gears=zmieniać biegi
check in=przejść odprawę biletowo-bagażową
cross a continent=przeprawić się przez kontynent
depart from=odjeżdżać, odlatywać z
fasten one's seat belts=zapiąć pasy bezpieczeństwa
find one's way=odnaleźć drogę
get finto a car/taxi=wsiąść do samochodu/taksówki
get lost=zgubić się
get off a bus/train=wysiadać z autobusu/pociągu
get on a bus/train=wsiąść do autobusu/pociągu
get out of a car/taxi=wysiadać z samochodu/taksówki
give sb a lift=podwieźć kogoś
give way=ustąpić pierwszeństwa
go by bus=pojechać autobusem
go by car=pojechać samochodem
go by train=pojechać pociągiem
go on foot|walk=pójść piechotą
go fast=jechać szybko
have a safe journey/trip=bezpiecznej podróży
have priority=mieć pierwszeństwo
make a reservation=zrobić rezerwację
meet sb at the airport=wyjść po kogoś na lotnisko
miss one's flight/plane=spóźnić się na samolot
reach the speed of 200 km per hour=osiągać prędkość 200 km/h
run out of petrol=nie mieć już benzyny
see sb off=odprowadzać kogoś
set off/out=wyruszać
show sb the way=wskazywać komuś drogę
start a car=uruchomić samochód
take a plane=polecieć samolotem
take a train=pojechać pociągiem
take off=startować
travel by air| travel by plane=podróżować samolotem
travel by bus=podróżować autobusem
travel by rail| travelby train=podróżować koleją
travel by sea| travelby=boat podróżować statkiem 
compartment=przedział
dining car=wagon restauracyjny
monorail=kolej jednoszynowa
platform=peron
rail travel=podróżowanie koleją 
railway=kolej
railway company=spółka kolejowa
railway station=stacja kolejowa
sleeping car=wagon sypialny
train=pociąg
direct train=pociąg bezpośredni
express train=ekspres, pociąg ekspresowy
fast train=pociąg pośpieszny
passenger train=pociąg pasażerski
sleeper train=pociąg z wagonami sypialnymi 
cabin=kabina, kajuta
cruise=rejs wycieczkowy
harbour/port=port
lifeboat=łódź ratunkowa
liner=statek dalekomorski, liniowiec
sea travel=podróż morska
voyage=podróż morska, długi rejs 
air travel=podróżowanie samolotem
airline=linia lotnicza
budget airline=tania linia lotnicza
airport=lotnisko
baggage reclaim=odbiór bagażu
belt=taśma, z której odbieramy bagaż po lądowaniu
boarding card/pass=karta pokładowa
cabin crew=personel pokładowy
check-in desk=stanowisko odprawy biletowo-bagażowej
departure lounge=poczekalnia dla odlatujących
duty-free zone=strefa bezcłowa
flight=lot
charter flight=rejs czarterowy
flight attendant=steward/stewardesa
gate=wyjście prowadzące do samolotu
hand luggage/baggage=bagaż podręczny
runway=pas startowy
security|security check|security screening=kontrola bezpieczeństwa
terminal=terminal 
bonnet=maska samochodu
boot=bagażnik 
brakes=hamulce
bumper=zderzak
crossroads/junction=skrzyżowanie
cycle/bike lane=pas dla rowerów
cycle/bike path=ścieżka rowerowa
fine/ticket=mandat
flat tyre/puncture=przebita opona
headlight=reflektor
mirror=lusterko
wing mirror=lusterko boczne
motorway/highway=autostrada
number plate=tablica rejestracyjna
pavement=chodnik
pedestrian=pieszy
petrol station=stacja benzynowa
red light=czerwone światło
right of way=pierwszeństwo przejazdu
road=droga, jezdnia, ulica
main road=główna ulica
minor road=boczna droga
road sign=znak drogowy
road travel=podróż samochodem
roundabout=rondo
seat=siedzenie
speed limit=ograniczenie prędkości
speeding=przekroczenie dozwolonej prędkości
steering wheel=kierownica
traffic=ruch uliczny
traffic congestion=duże natężenie ruchu ulicznego, korki
traffic jam=korek
traffic lights=sygnalizacja świetlna
tyre=opona
windscreen=przednia szyba
wiper=wycieraczka szyby samochodowej
zebra crossing=przejście dla pieszych 
accommodation=zakwaterowanie
bed and breakfas|tB&B=nocleg ze śniadaniem; pensjonat oferujący nocleg ze śniadaniem
campsite=pole namiotowe, kemping
caravan=przyczepa kempingowa
en suite=z łazienką
guest house=pensjonat
hotel=hotel
including breakfast=śniadanie wliczone w cenę pokoju
reception=recepcja 
receptionist=recepcjonista
room=pokój
double room=pokój dwuosobowy z podwójnym łóżkiem
single room=pokój jednoosobowy
twin room|twin-bedded room=pokój z dwoma łóżkami
sleeping bag=śpiwór
suite=apartament
tent=namiot
youth hostel=schronisko młodzieżowe 
be fully booked =nie mieć wolnych miejsc
check in=zameldować się
check into a hotel=zameldować się w hotelu
check out=wymeldować się
put up a tent=rozłożyć namiot
stay at=zatrzymać się w 
adventure=przygoda
coastal path=ścieżka wzdłuż wybrzeża
hike=piesza wędrówka
holiday=wakacje
holiday destination=miejsce, do którego jedziemy na wakacje
package holiday=wczasy zorganizowane
holiday resort=miejscowość wypoczynkowa
holidaymaker=wczasowicz
scenery=krajobraz
souvenir=pamiątka
tacky souvenir=tandetna pamiątka
tourist=turysta
tourist attractions=atrakcje turystyczne
travel agency/agent=biuro podróży 
at the seaside=nad morzem
camp in the mountains=obozować w górach
cut one's holiday short=skrócić wakacje
go backpacking=wędrować z plecakiem
go camping=pojechać pod namiot
go for a ride=pojechać na przejażdżkę
go hiking=pójść na pieszą wędrówkę
go on a cruise=pojechać w rejs wycieczkowy
go on holiday=pojechać na wakacje
go sightseeing|see the sights=zwiedzać
have a go at sth=spróbować czegoś
have fun=dobrze się bawić
lie on the beach=leżeć na plaży
make a trip| make an excursion=pojechać na wycieczkę
put sun cream on=nałożyć balsam do opalania 
take a ride=pojechać na przejażdżkę
take a walk=pójść na spacer 
customs=urząd celny, kontrola celna
customs officer=celnik
exchange office=kantor wymiany walut
foreign currency=obca waluta
immigration officer=przedstawiciel urzędu imigracyjnego
passport control=kontrola paszportowa
walid passport=ważny paszport
invalid passport=nieważny paszport
visa=wiza 
cross the border=przekraczać granicę
travel abroad=podróżować za granicę
travel across Europe=podróżować po Europie
travel around the world=podróżować dookoła świata 
accident=wypadek
casualty=ofiara wypadku
crash=wypadek samochodowy
plane crash=wypadek lotniczy
train crash=wypadek kolejowy
emergency=nagły wypadek, sytuacja awaryjna
emergency landing=przymusowe lądowanie
emergency services=służby ratownicze
first aid=pierwsza pomoc
life jacket=kamizelka ratunkowa
narrow escape=ucieczka w ostatniej chwili
rescue=ratunek
safety=bezpieczeństwo
shipwreck=wrak statku 
rescue=ratować
sink=zatonąć
survive=przeżyć 
be hit by a car=zostać potrąconym przez samochód
be seasick=mieć chorobę morską
bump into sth=wjechać w coś
call an ambulance=wezwać karetkę
crash into a tree=rozbić się o drzewo
have a crash| have an accident=mieć wypadek
have a flat tyre=złapać gumę
run sb/sth over=przejechać kogoś/ coś 

[Unit 9 Kultura]
art=sztuka
piece of art|work of=dzieło sztuki
artist=artysta
award=nagroda
character=postać
main character=główny bohater
creation=dzieło
creator=twórca
critic=krytyk
culture=kultura
entertainment=rozrywka
film/movie/picture=film
graphic arts=grafika
hero=bohater
heroine=bohaterka
literature=literatura
masterpiece=arcydzieło
music=muzyka
performance=przedstawienie, występ
photography=fotografia
review=recenzja
reviewer=recenzent
scene=scena, część sztuki, książki lub filmu
theatre=teatr
the media=środki masowego przekazu
TV/television=telewizja
visual arts=sztuki plastyczne
well-known=słynny 
create=tworzyć
recommend sth to sb=polecać coś komuś
rehearse=robić próby
review=zrecenzować 
art book=album o sztuce
art class=zajęcia ze sztuki
art gallery=galeria sztuki
background=tło
designer=projektant
doodles=bazgroły 
drawing=rysunek
exhibition=wystawa
gallery=galeria
landscape=pejzaż
museum=muzeum
painter=malarz
painting=obraz
abstract painting=obraz abstrakcyjny
oil painting=obraz olejny
perspective=perspektywa
photographer=fotograf
portrait=portret
sculptor=rzeźbiarz
sculpture=rzeźba
self-portrait=autoportret
sketch=szkic
still life=martwa natura
studio=pracownia 
design=projektować
draw=rysować
paint=malować
sculpt=rzeźbić
sketch=szkicować 
draw in chalk=rysować kredą
draw in charcoal=rysować węglem
draw in pencil=rysować ołówkiem
take photographs|take photos=robić zdjęcia 
bridge=most
castle=zamek
cathedral=katedra
church=kościół
city walls=mury miasta
monument=pomnik, zabytek 
bestseller=bestseller
chapter=rozdział
collection of short stories=zbiór opowiadań
crime/detective story=kryminał
fairy tale=baśń
fiction=beletrystyka, literatura piękna 
Nobel Prize=Nagroda Nobla
non-fiction=literatura faktu
novel=powieść
novelist=powieściopisarz
play=sztuka teatralna
poem=wiersz
poet=poeta
poetry=poezja
short story=opowiadanie
trilogy=trylogia
volume=tom
writer=pisarz 
act=akt sztuki teatralnej
curtain=kurtyna
drama=dramat
interval=antrakt
performance=przedstawienie
programme=program
seat=miejsce, siedzenie
show=przedstawienie
stage=scena 
Academy Award|Oscar=Oscar
act=grać
acting=gra aktorska
action film/movie=film akcji
adaptation=adaptacja
adventure film=film przygodowy
agent=agent
audition=przesłuchanie do roli
blockbuster=przebój filmowy
cameraman=operator, kamerzysta
cartoon=film rysunkowy, kreskówka
cast=obsada
cinema=kino
comedy=komedia
dialogue=dialog
dialogues=dialogi
director=reżyser
disaster movie=film katastroficzny
documentary=film dokumentalny
dubbed=dubbingowany
dubbing=dubbing
feature film=pełnometrażowy film fabularny
album=album
horror=horror
leading/main role=rola główna
love story=historia miłosna, romans
make-up artist=charakteryzator
musical=musical
part=rola
plot=fabuła
producer=producent
production=produkcja
psychological drama=dramat psychologiczny
remake=nowa wersja filmu
romantic comedy=muzyka ludowa, muzyka folk
science fiction film|sci-fi film=film science fiction
screenplay=scenariusz
shot=ujęcie
soundtrack=ścieżka dźwiękowa
special effects=efekty specjalne
subtitled=z napisami
subtitles=napisy
thriller=film sensacyjny, thriller
viewer=widz
war drama=dramat wojenny
western=western
appear=występować, grać
cast=obsadzać
direct=reżyserować
dub=dubbingować
release=wydać, wprowadzić na rynek/na ekrany
shoot=kręcić, filmować
based on a book=oparty na książce
based on a true story=oparty na prawdziwej historii
make a book into a film=zekranizować książkę
make a film=kręcić film
play the part|role of sb=grać rolę kogoś
set in=osadzony w
star in a film=grać, występować
study at drama school=studiować w szkole teatralnej
tell the story of sb/sth=opowiadać o kimś/czymś
the action takes place in=akcja odbywa się w
what's on=co grają
worth seeing=warty zobaczenia 
album=album
ballet=balet
band/group=zespół muzyczny
charts=lista przebojów
classical music=muzyka poważna
composer=kompozytor
concert=koncert
concert hall=sala koncertowa
conductor=dyrygent
cover=przeróbka utworu
folk music=muzyka ludowa, muzyka folk
gig=koncert muzyki rozrywkowej
guitar player|guitarist=gitarzysta
hit=przebój
line-up=skład zespołu
lyrics=tekst piosenki
modern music=muzyka nowoczesna
musician=muzyk
number one hit=hit, przebój
opera=opra
orchestra=orkiestra
piece of music=utwór muzyczny
record=płyta
recording contract=kontrakt płytowy
recording studio=studio nagraniowe
rehearsal=próba
release of a single=ukazanie się singla
singer=piosenkarz
solo career=kariera solowa
songwriter=autor piosenek
tour=tournee
vocalist=wokalista
lead vocalist=główny wokalista
bass guitar=gitara basowa
drum=bęben
guitar=gitara
keyboard=syntezator, keyboard
percussion/drums=perkusja
piano=fortepian
saxophone=saksofon
trumpet=trąbka
violin=skrzypce
compose=komponować
conduct=dyrygować
perform=występować
play=grać 
play an instrument=grać na instrumencie 
article=artykuł
broadcast=transmisja
live broadcast=transmisja na żywo
cable TV=telewizja kablowa
cartoon=film animowany, kreskówka
cartoonist=rysownik kreskówek/komiksów
copy=egzemplarz
correspondent=korespondent
war correspondent=korespondent wojenny
daily|daily paper|newspaper=gazeta codzienna, dziennik
editor=redaktor
episode=odcinek
game/quiz show=teleturniej
headline=nagłówek prasowy
interwiew=wywiad
journalist=dziennikarz
letter to the editor=list do redakcji
local press=prasa lokalna
magazine=czasopismo, magazyn
glossy magazine=magazyn ilustrowany
women's magazine=magazyn dla kobiet
media celebrity=osoba znana z mediów
monthly=miesięcznik
national press=prasa ogólnokrajowa
national TV and radio=stacja telewizyjna i radiowa o zasięgu krajowym
newsagent=sprzedawca prasy
presenter=prezenter
quiz show=teleturniej
reality show=reality show
reality TV=reality TV
remote control=pilot do telewizora
report=doniesienie, relacja
reporter=reporter
satellite=telewizja satelitarna 
series/serial=serial
sitcom=serial komediowy
soap opera=telenowela, opera mydlana
Sunday paper=niedzielne wydanie gazety codziennej
talk show host=gospodarz talk show
talk/chat show=talk show
the front page=pierwsza strona gazety
the news=wiadomości
TV channel=kanał telewizyjny
TV studio=studio telewizyjne
weekly=tygodnik 
comment=komentować
inform=informować
interwiew sb=przeprowadzić z kimś wywiad 
post sth on a website=zamieścić coś na stronie internetowej 
audience=widownia
box office=kasa biletowa
festiwal=festiwal
live=na żywo
venue=miejsce, gdzie coś się odbywa 
applaud=oklaskiwać
clap=klaskać
amazing=zdumiewający
awful=okropny
believable=wiarygodny
boring=nudny
brilliant=znakomity
colourful=barwny
disappointing=rozczarowujący
dreadful=okropny, fatalny
entertaining=zabawny
excellent=świetny
fantastic=fantastyczny
good=dobry
poor/weak=słaby

[Unit 10 Sport]
aerobics=aerobik
aikido=aikido
archery=łucznictwo
athletics=lekkoatletyka
badminton=badminton
baseball=baseball
basketball=koszykówka
bowling=gra w kręgle
boxing=boks
bridge=brydż
car racing=wyścigi samochodowe
chess=szachy
climbing=wspinaczka
combat sport=sport walki
cricket=krykiet
cycling=kolarstwo
dancing=taniec
darts=rzutki
discus=rzut dyskiem
diving=nurkowanie
dodgeball=gra w dwa ognie
fencing=szermierka
football/soccer=piłka nożna
freestyle=styl dowolny w pływaniu
golf=golf
gymnastics=gimnastyka
hammer throw=rzut młotem
high jump=skok wzwyż
hockey=hokej
horseracing=wyścigi konne
hurdling=bieg przez płotki
individual sport=sport indywidualny
indoor sport=sport halowy
javelin=rzut oszczepem
jogging=jogging
judo=dżudo
karate=karate
kung fu=kung fu
long jump=skok w dal 
long-distance running=biegi długodystansowe
marathon=maraton
outdoor sport=sport uprawiany na świeżym powietrzu
rollerblading=jazda na rolkach
rowing=wioślarstwo
rugby=rugby
running=bieganie
sailing=żeglarstwo
skateboarding=jazda na deskorolce
skating=łyżwiarstwo
figure skating=łyzwiarstwo figurowe
speed skating=łyżwiarstwo szybkie
ski jumping=skoki narciarskie
skiing=narciarstwo
snowboarding=snowboarding
snooker=snooker
sprint=sprint
squash=squash
swimming=pływanie
table tennis=tenis stołowy
team sport=sport zespołowy
tennis=tenis
volleyball=siatkówka
walk=chód
water sport=sport wodny
weightlifting=podnoszenie ciężarów
windsurfing=windsurfing
winter sport=sport zimowy
wrestling=zapasy
yoga=joga 
ball=piłka
bat=rakietka, kij
bobsleigh=bobslej
chess pieces=figury szachowe
football boots=korki
football kit=strój do gry w piłkę nożną
football shirt=koszulka piłkarska
gloves=rękawice
boxing gloves=rękawice bokserskie 
goal=bramka
goggles=okulary, gogle
swimming goggles=okulary pływackie
golf club=kij golfowy
helmet=kask
ice skates=łyżwy
kayak=kajak
net=siatka
pedal=pedał
rollerblades=rolki
shin pad=ochraniacz, nagolennik
skateboard=deskorolka
ski boots=buty narciarskie
ski lift=wyciąg narciarski
ski poles=kijki narciarskie
ski suit=kombinezon narciarski
sports equipment=sprzęt sportowy
swimming cap=czepek
swimming costume=kostium kąpielowy
swimming trunks=kąpielówki
tennis ball=piłeczka tenisowa
tennis racket=rakieta do tenisa
tennis shoes=buty do tenisa
tennis table=stół do tenisa
tracksuit=dres
trainers=buty sportowe 
basketball court=boisko do koszykówki
boxing ring=ring bokserski
football pitch|football field=murawa, boisko do piłki nożnej
gym=siłownia, sala gimnastyczna
race track=tor wyścigowy
skating/ice rink=lodowisko
ski run=trasa narciarska
ski slope=stok narciarski 
stadium=stadion
stand=trybuna
swimming pool=basen
tennis court=kort tenisowy
track=bieżnia, tor
volleyball court=boisko do siatkówki 
amateur=amator
archer=łucznik
athlete=sportowiec, lekkoatleta
basketball player=koszykarz
boxer=bokser
captain=kapitan
champion=mistrz
coach=trener
contestant=zawodnik
crowd=tłum, kibice
cyclist=rowerzysta
diver=nurek, skoczek do wody
springboard=skoczek do wody z trampoliny
fan/supporter=kibic
fencer=szermierz
football player|footballer=piłkarz
goalkeeper=bramkarz
golfer=golfista
gymnast=gimnastyk
hockey player=hokeista
jumper=skoczek
marathon runner=maratończyk
opponent/rival=przeciwnik
professional=zawodowiec
referee=sędzia sportowy
runner=biegacz
sailor=żeglarz
skater=łyżwiarz
figure skater=łyżwiarz figurowy
speed skater=panczenista
ski jumper=skoczek narciarski
skier=narciarz
spectator=widz
sprinter=sprinter
swimmer=pływak
team=drużyna
home team=drużyna gospodarzy
tennis player=tenisista 
weightlifter=sztangista
windsurfer=windsurfer
wrestler=zapaśnik 
athletic=wysportowany
exhausted=wyczerpany
fit=sprawny, w dobrej kondycji
sporty=wysportowany 
attack=atakować
beat=pokonać
cheer=wiwatować, wznosić okrzyki
compete=współzawodniczyć, konkurować
defend=bronić
disqualify=zdyskwalifikować
dive=nurkować, skakać do wody
fight=walczyć
kick=kopać
lose=przegrać
play=grać
practise=trenować, ćwiczyć
qualify=zakwalifikować się
race=ścigać się
score=zdobyć punkt, strzelić bramkę, rzucić kosza
sponsor sb=sponsorować kogoś
support sb=kibicować komuś
train=trenować
win=wygrać 
be out of breath=nie móc złapać tchu
be out of shape=nie być w formie
be useless at sth=być w czymś kiepskim
become a professional=zostać zawodowym sportowcem
break a record=pobić rekord
catch the ball=złapać piłkę
come first=zająć pierwsze miejsce
do aerobics=uprawiać aerobik
do aikido=uprawiać aikido
do athletics=uprawiać lekkoatletykę
do exercise=ćwiczyć
do karate=uprawiać karate
do kung fu=uprawiać kung fu
do sports=uprawiać sport
do yoga=uprawiać jogę
equal a record=wyrównać rekord 
give up=poddawać się
go climbing=wspinać się
go cycling|cycle=jeździć na rowerze
go riding|ride a horse=jeździć konno
go rollerblading|rollerblade=jeździć na rolkach
go sailing=żeglować
go skateboarding=jeździć na deskorolce
go skiing|ski=jeździć na nartach
go surfing=uprawiać windsurfing
go swimming|swim=pływać
go windsurfing=uprawiać windsurfing
have practice=mieć trening
in the lead=na prowadzeniu
join a gym=zapisać się na siłownię
keep fit=utrzymywać dobrą formę
knock sb out=znokautować kogoś
let in a goal=puścić gola
lose a game/match=przegrać mecz
lose a race=przegrać wyścig
miss the goal/kick=chybić, nie trafić do bramki
participate in|take part in=brać udział w
play against sb=grać przeciwko komuś
play badminton=grać w badmintona
play basketball=grać w koszykówkę
play bridge=grać w brydża
play football=grać w piłkę nożną
play rugby=grać w rugby
 play squash=grać w squasha
play tennis grać=w tenisa
play volleyball=grać w siatkówkę
prepare for the Olympics=przygotowywać się do olimpiady
ride a motorcycle=jeździć na motocyklu
run a marathon=biec w maratonie
running isn't my thing=nie przepadam za bieganiem
score a goal=strzelić gola
score a point=zdobyć punkt
set a record=ustanowić rekord
take on a challenge=podjąć wyzwanie
take up a sport=zacząć uprawiać sport
turn professional=przejść na zawodowstwo
win a game/match=wygrać mecz
win a race=zwyciężyć w wyścigu
win a sporting competition=wygrać zawody sportowe
work out at the gym=ćwiczyć na siłowni
competition=konkurencja, zawody
contest=konkurs
cycling race=wyścig kolarski
division=liga
first division=pierwsza liga
second division=druga liga
doping=stosowanie środków dopingujących
draw=remis
drug test=test antydopingowy
European Championship=mistrzostwa Europy
final=finał
game=mech, gra
half=połowa
first half=pierwsza połowa
second half=druga połowa
half-time=przerwa w połowie meczu
lap=okrążenie
live commentary=komentarz na żywo
match=mecz
medal=medal
bronze medal=brązowy medal
gold medal=złoty medal
silver medal=srebrny medal
Olympic Games|Olympics=olimpiada
Olympic sport=sport olimpijski
penalty=rzut karny
point=punkt
race=wyścig, bieg
relay=sztafeta
record=rekord
world record=rekord świata
round=runda
score=wynik meczu
semi-final=półfinał
sporting event=wydarzenie sportowe
tournament=turniej
trophy=trofeum, puchar
victory=zwycięstwo
World Championship=mistrzostwa świata
World Cup=mundial 

[Unit 11 Zdrowie]
ankle=kostka
bone=kość
chest=klatka piersiowa
gene=gen
heart=serce
liver=wątroba
lung=płuco
muscle=mięsień
organ=narząd
rib=żebro
skull=czaszka
spine=kręgosłup
stornach=żołądek
throat=gardło
tonsil=migdałek
wrist=nadgarstek 
accident=wypadek
Alzheimer's disease=choroba Alzheimera
appendicitis=zapalenie wyrostka robaczkowego
asthma=astma
backache=ból pleców
broken arm=złamana ręka
broken ribs=złamane żebra
bruise=siniak
burn=oparzenie
cancer=rak
lung cancer=rak płuc
chicken pox=ospa wietrzna
cold=przeziębienie
concussion=wstrząśnienie mózgu
condition=schorzenie
skin condition=schorzenie skóry
cough=kaszel
curable=uleczalny
incurable=nieuleczalny
cut=skaleczenie
diabetes=cukrzyca
diarrhoea=biegunka
disease=choroba
fatal disease=choroba śmiertelna
heart disease=choroba serca
dizziness=zawroty głowy
earache=ból ucha
epilepsy=epilepsja
fast pulse=szybkie tętno
fever=gorączka
flu=grypa
food poisoning=zatrucie pokarmowe
hay fever=katar sienny
headache=ból głowy
heart attack=zawał serca
heart-related illnesses=choroby związane z układem krążenia
ill=chory
illness=choroba
infected=zarażony, zakażony
injured=kontuzjowany, ranny
injury=uraz, obrażenie, kontuzja 
insect bite=ukąszenie owada
insomnia=bezsenność
irritated=podrażniony
jaundice=żółtaczka
measles=odra
motion sickness=choroba lokomocyjna
mumps=świnka
numb=zdrętwiały, bez czucia
pain=ból
painful=bolesny
pneumonia=zapalenie płuc
rash=wysypka
runny nose=katar
scratch=zadrapanie
sore throat=bolące gardło
sprained wrist=skręcony nadgarstek
stornach cramp=skurcz żołądka
stomachache=ból brzucha
stroke=udar
swollen tonsils=powiększone migdałki
symptom=objaw
toothache=ból zęba
twisted ankle=zwichnięta kostka
upset stornach=problemy z żołądkiem
wirus=wirus
wound=rana
open wound=otwarta rana
wounded=ranny 
bleed=krwawić
burn=oparzyć
choke=krztusić się, dławić się
cough=kaszleć
faint=zemdleć
feel=czuć się
hurt=boleć
shiver=mieć dreszcze
sneeze=kichać
snore=chrapać
tremble=drżeć
vomit=wymiotować 
allergic to sth=uczulony na coś
bad for one's eyes/lungs=niezdrowy dla oczu/płuc
be in pain=cierpieć ból
be short of breath=dostawać zadyszki
be unconscious=być nieprzytomnym
catch a cold=przeziębić się
die of sth=umrzeć na coś
feel chilly=odczuwać zimno
feel dizzy=mieć zawroty głowy
feel hot=być rozpalonym
feel sick=mieć mdłości
have a pain in one's leg=mieć ból w nodze
look sick=wyglądać na chorego
lose one's sight=stracić wzrok
my arm hurts=boli mnie ręka
my eyes are sore=bolą mnie oczy
regain one's sight=odzyskać wzrok
run a fever=mieć gorączkę
run/have a high temperature=mieć wysoką temperaturę
suffer from a disease=cierpieć na chorobę
depression=depresja
hypochondriac=hipochondryk
sleep disorder=zaburzenia snu
tiredness=zmęczenie
well-being=dobre samopoczucie 
feel a bit poorly=czuć się nie najlepiej
feel depressed=czuć się przygnębionym
feel good/fine/OK=czuć się dobrze
feel terrible=czuć się okropnie
feel tired=czuć się zmęczonym
feel weak=czuć się słabo 
bandage=bandaż
blood pressure=ciśnienie krwi
drops=krople
examination=badanie
first aid=pierwsza pomoc
herb=zioło
injection=zastrzyk
medical advice=porada lekarska
medical check-up=wizyta kontrolna u lekarza
medication/medicine/drug=lekarstwo
natural remedy=naturalne lekarstwo
ointment=maść
painkiller=środek przeciwbólowy
pill=tabletka
sleeping pill=tabletka nasenna
plaster/band-aid=plaster
plaster|cast|plaster cast=gips
prescription=recepta
rest=odpoczynek
side effects=skutki uboczne
stethoscope=stetoskop
surgery/operation=operacja
thermometer=termometr
treatment=leczenie, terapia
vaccine=szczepionka
vitamin=witamina
X-ray=prześwietlenie 
bandage=bandażować
cure=wyleczyć
diagnose=diagnozować
prescribe=przepisać lekarstwo, kurację
treat=leczyć 
carry out an operation|perform an operation=przeprowadzić operację 
consult/see a doctor=zasięgnąć porady lekarza
drink lots of liquids/fluids=pić dużo płynów
examine sb|give sb an examination=zbadać kogoś
extract a tooth=wyrywać ząb
get better=wydobrzeć
give sb an injection=dać komuś zastrzyk
go to hospital=iść do szpitala
go to the doctor's=iść do lekarza
look well=wyglądać zdrowo
make an appointment with a doctor=umawiać się na wizytę lekarską
operate on sb=operować kogoś
put sth in a cast=założyć gips
recover from sth=wyzdrowieć z czegoś
run tests=przeprowadzić badania
see patients=przyjmować pacjentów
stick a plaster on sth=przykleić plaster
take an antibiotic=wziąć antybiotyk
take sb's blood pressure=mierzyć komuś ciśnienie
take sb's temperature=mierzyć komuś temperaturę 
Accident and Emergency department=ostry dyżur
accident victim=ofiara wypadku
ambulance=karetka pogotowia
dentist=dentysta
doctor=lekarz
General Practitioner|GP=lekarz rodzinny
health care=służba zdrowia
public health care=publiczna służba zdrowia
health centre=przychodnia
hospital=szpital
hospital bed=łóżko szpitalne
hospital ward=oddział szpitalny
nurse=pielęgniarz/pielęgniarka
operating theatre=sala operacyjna
paramedic=sanitariusz
patient=pacjent
pharmacy=apteka
physiotherapist=fizjoterapeuta
specialist=specjalista
stretcher=nosze
surgeon=chirurg
surgery=gabinet lekarski 
blind=niewidomy
deaf=głuchy
disability=niepełnosprawność
disabled=niepełnosprawny
mentally disabled=niepełnosprawny umysłowo
physically disabled=niepełnosprawny fizycznie
dumb=niemy
hard of hearing=niedosłyszący 
short-sighted=krótkowzroczny
wheelchair=wózek inwalidzki
wheelchair user=osoba poruszaaca na wózku inwalidzkim 
healthy=zdrowy
healthy diet=zdrowa dieta
healthy food=zdrowe jedzenie
healthy habits=zdrowe nawyki
healthy lifestyle=zdrowy tryb życia
high-fat food=żywność o wysokiej zawartości tłuszczu
life expectancy=długoś życia
low-fat food=żywność o niskiej zawartości tłuszczu
obesity=otyłość
unhealthy lifestyle=niezdrowy tryb życia 
avoid stress=unikać stresu
be in good health=cieszyć się dobrym zdrowiem
be overweight=mieć nadwagę
breathe smoke=wdychać dym
cut down on fatty food=ograniczyć spożywanie tłustych pokarmów
do/take regular exercise=regularnie ćwiczyć
follow a sensible diet=przestrzegać rozsądnej diety
get enough sleep=wysypiać się
give up smoking=rzucić palenie
have a check-up=przechodzić kontrolne badanie lekarskie
improve one's memory=poprawiać pamięć
in good shape=w dobrej formie
keep fit/stay fit=utrzymywać dobrą formę
lose weight=schudnąć
out of shape=w złej formie
prevent cancer=zapobiegać rakowi
reduce stress=ograniczać stres
take a nap=zdrzemnąć się
take things easy=nie przemęczać się
take up a sport=zacząć uprawiać jakiś sport
work out at the gym=ćwiczyć na siłowni 
addict=osoba uzależniona
drug addict=narkoman/narkomanka
addiction=uzależnienie
alcohol=alkohol
caffeine=kofeina
drugs=narkotyki
therapy=terapia 
be addicted to sth=być od czegoś uzależnionym
be in therapy=przechodzić terapię
get addicted to sth=uzależnić się od czegoś
take an overdose=przedawkować

[Unit 12 Nauka i technika]
archaeologist=archeolog
archeology=archeologia
area/branch/field of science=dziedzina nauki
astronomer=astronom
astronomy=astronomia
biologist=biolog
biology=biologia
chemist=chemik
chemistry=chemia
computer science=informatyka
economics=ekonomia
economist=ekonomista
engineer=inżynier
engineering=inżynieria
geneticist=genetyk
genetics=genetyka
geographer=geograf
geography=geografia
geologist=geolog
geology=geologia
linguist=językoznawca
linguistics=językoznawstwo
mathematician=matematyk
mathematics/maths=matematyka
physicist=fizyk
physics=fizyka
nuclear physics=fizyka jądrowa
psychologist=psycholog
psychology=psychologia
scientist=naukowiec
sociologist=socjolog
sociology=socjologia
veterinary medicine=medycyna weterynaryjna 
analysis=analiza
conclusion=wniosek 
connection/link=związek, połączenie
discovery=odkrycie
evidence=dowody
experiment=doświadczenie, eksperyment
hypothesis=hipoteza
invention=wynalazek
inventor=wynalazca
knowledge=wiedza
laboratory/lab=laboratorium, pracownia
observation=obserwacja
record=zapis, dokumentacja
research/study=badania
research/study findings/results=wyniki badań
researcher=pracownik naukowy, badacz
science=nauka
scientific=naukowy
scientific journal=czasopismo naukowe
scientific law=prawo naukowe
scientific method=metoda naukowa
scientific theory=teoria naukowa
scientifically=naukowo
statistical data=dane statystyczne
statistically=statystycznie
statistics=statystyka
survey=badania, sondaż
test=próba, analiza
theory=teoria 
accept=przyjmować, akceptować
add=dodawać
analyse=analizować, przeprowadzać analizę
confirm=potwierdzić
demonstrate=pokazać, wykazać
determine=ustalać, określać
discover|find out=odkryć
divide=dzielić
duplicate=powielić
estimate=oszacować
experiment=przeprowadzać doświadczenia 
hypothesise=postawić hipotezę
invent=wynaleźć
multiply=mnożyć
observe=obserwować, prowadzić obserwacje
obtain=otrzymać
prove=udowodnić
reject=odrzucić
study/investigate=badać
subtract=odejmować 
award/win the Nobel Prize in physics=otrzymać Nagrodę Nobla w dziedzinie fizyki
carry out an experiment|conduct an experiment|do an experiment=przeprowadzać doświadczenie
carry out an experiment|conduct an experiment|do research=przeprowadzać badania
come to the conclusion that=dojść do wniosku, że
confirm a hypothesis=potwierdzić hipotezę
formulate a hypothesis=formułować hipotezę
keep records=prowadzić dokumentację
make a discovery=dokonać odkrycia
make predictions|predict=przewidywać
patent an invention=opatentować wynalazek
present research findings=prezentować wyniki badań
reject a hypothesis=odrzucić hipotezę
specialise in sth=specjalizować się w czymś
undertake research=podjąć badania 
bacteria=bakterie
cell=komórka
chemical element=pierwiastek chemiczny
chemical reaction=reakcja chemiczna
compound=związek chemiczny
concentrated=zagęszczony
development=rozwój
formula=wzór, formuła
gas=gaz
genetically modified food| GM food=żywność modyfikowana genetycznie
germ/microbe=drobnoustrój, zarazek
gravity=grawitacja
hydrogen=wodór
liquid=ciecz
magnesium=magnez
magnetic forces=siły magnetyczne
mass=masa
minerał=minerał
molecule=cząsteczka, molekuła
mould=pleśń
oxygen=tlen
rate=tempo, prędkość
salt=sól
salty=słony
sodium=sód
solid=ciało stałe
steam=para
theory of evolution=teoria ewolucji
vaccine=szczepionka
witamin=witamina 
assimilate=przyswajać
consist of=składać się z
contain=zawierać
dissolve=rozpuszczać, rozpuszczać się
evaporate=parować, wyparować
exhale=wydychać
extinguish=gasić
freeze=zamrozić, zamarzać
melt=topnieć
oxidise=utleniać 
aerial=antena
button=przycisk
cable=kabel
camera=aparat fotograficzny
charger=ładowarka
controls=układ sterowania
device=urządzenie
digital=cyfrowy
digital addict=osoba uzależniona od nowych technologii
digital native=cyfrowy tubylec, osoba urodzona w erze cyfrowej
electricity=energia elektryczna
electromagnet=elektromagnes
electronic=elektroniczny
engine=silnik
internal combustion=silnik spalinowy
gadget=przyrząd, gadżet
gamepad=gamepad
headphones=słuchawki 
lens=soczewka
light bulb=żarówka
machine=maszyna
manual=instrukcja obsługi
microphone=mikrofon
microwaves=mikrofale
mobile phone=telefon komórkowy
mobile phone handset=zestaw słuchawkowy
mobile phone operator=operator telefonii komórkowej
MP3 player=odtwarzacz MP3
nuclear power=energia jądrowa
photocopier=kserokopiarka
plug=wtyczka
remote control=pilot
sensor=czujnik
smartphone=smartfon
socket=gniazdko
sound=dźwięk
switch=przełącznik
on-off switch=włącznik
tablet=tablet
technological innovation=innowacja technologiczna
technology=technika
text message=SMS
touch screen=ekran dotykowy
transistor=tranzystor
transmitter=nadajnik, przekaźnik
virtual reality=rzeczywistość wirtualna
wireless=bezprzewodowy 
hover=unosić się w powietrzu
jam=zaciąć się, zaklinować się
power=napędzać
scan=skanować
text=pisać SMSy
transform=zmieniać, przekształcać
work=działać 
come out=ukazywać się
press a button=nacisnąć guzik
receive texts=dostawać SMSy
switch off=wyłączyć
switch on=włączyć 
attachment=załącznik
backup=kopia zapasowa 
battery=bateria, akumulator
battery life=żywotność baterii, akumulatora
CD=płyta kompaktowa
CD-ROM drive=napęd CD-ROM
computer programme=program komputerowy
computer programmer=programista
cursor=kursor
data=dane
database=baza danych
disk=dysk
hard disk=twardy dysk
document=dokument
DVD drive=napęd DVD
external memory=pamięć zewnętrzna
file=plik
flash/memory card=karta pamięci
folder=katalog
icon=ikona
information technology|IT=informatyka
Internet connection=łącze internetowe
key=klawisz
keyboard=klawiatura
laser printer=drukarka laserowa
monitor=monitor
mouse=mysz
online=w sieci
pendrive|memory stick=pamięć USB
personal computer|PC=komputer stacjonarny
scanner=skaner
screen=ekran
blank screen=pusty ekran
flat screen monitor=płaski monitor
social networking site=portal społecznościowy
software=oprogramowanie
anti-virus software=oprogramowanie antywirusowe
speakers=głośniki
the Internet=internet
USB port=port USB
website=strona internetowa 
attach=załączać
click=kliknąć
delete=skasować
download=ściągać
install=instalować 
print=drukować
save=zapisać
upload=wysyłać na serwer internetowy
create a document=tworzyć dokument
double click=kliknąć dwa razy
open a document=otworzyć dokument
process data=przetwarzać dane
share content=udostępniać pliki
surf the net=surfować po internecie 
backup=kopia zapasowa
crash=awaria
crash=zepsuć się
error=błąd
error message=komunikat o błędzie
wirus=wirus 
break down=zepsuć się
lose a document=stracić dokument
make funny noises=wydawać dziwne dźwięki
out of order=nie działa
reboot/restart a computer=restartować komputer 
astronaut=astronauta
atmosphere=atmosfera
comet=kometa
lift-off=start statku kosmicznego
meteor=meteor
orbit=orbita
in orbit=na orbicie
outer space=przestrzeń kosmiczna
planet=planeta
rocket=rakieta
satellite=satelita
space=kosmos
space exploration=badania kosmosu
base station=stacja kosmiczna
the Earth=Ziemia
the Moon=Księżyc
the Sun=Słońce
spacecraft/spaceship=statek kosmiczny
star=gwiazda
universe=wszechświat 
launch=wystrzelić
orbit sth=okrążać coś
rotate=obracać wokół własnej osi 
launch a rocket=wystrzelic rakietę
send sth into space=wysłać w kosmos

[Unit 13 Świat przyrody]
beach=plaża
rocky beach=skalista plaża
sandybeach=piaszczysta plaża
breathtaking=zapierający dech w piersiach
cave=jaskinia
cliff=klif, urwisko
coast=wybrzeże
coastline=linia brzegowa
continent=kontynent
coral reef=rafa koralowa
desert=pustynia
field=pole
forest|wood|the woods=las
glacier=lodowiec
hill=wzgórze, pagórek
island=wyspa
lake=jezioro
landscape=krajobraz
magnificent=wspaniały
mountain=góra
mountain range=łańcuch górski
top=szczyt
ocean=ocean
reservoir=zbiornik
river=rzeka
sand=piasek
scenery=pejzaż, krajobraz
sea=morze
shore=brzeg morza, jeziora
stream=strumień
valley=dolina
view=widok
waterfall=wodospad
wave=fala 
above zero=powyżej zera
below zero=poniżej zera
breeze=lekki wiatr
chilly=zimny, zimno
climate=klimat
mild/moderate climate=klimat umiarkowany
cloud=chmura
cloudy=pochmurny, pochmurno
cold=zimny, zimno
cool=chłodny, chłodno
degrees Celsius/Centigrade=stopnie Celsjusza
degrees Fahrenheit=stopnie Fahrenheita
dry=suchy, sucho
fog=mgła
foggy=mglisty, mglisto
freezing=przenikliwie zimny, przenikliwie zimno
frost=mróz
frosty=mroźny, mroźno 
heat=upał
hot=gorący, gorąco
humid=wilgotny
ice=lód
icy=lodowaty
lightning=błyskawica
meteorologist=meteorolog
meteorology=meteorologia
mild=łagodny
mist=lekka mgła
misty=mglisty, mglisto
pressure=ciśnienie
rain=deszcz
rainfall=opady deszczu
rainy=deszczowy, deszczowo
shower=przelotny deszcz
showery=z przelotnymi opadami deszczu
sky=niebo
blue sky=błękitne niebo
clear sky=bezchmurne niebo
snow=śnieg
snowy=śnieżny, śnieżnie
storm=burza
stormy=burzowy, burzowo
sun=słońce
sunny=słoneczny, słonecznie
sunshine=światło słoneczne, słońce
temperature=temperatura
average temerature=średnia temperatura
thunder=grzmot
warm=ciepły, ciepło
weather=pogoda
weather forecast=prognoza pogody
weather map=mapa pogody
wet=mokry, mokro
wind=wiatr
windy=wietrzny, wietrznie 
blow=wiać
rain=padać, o deszczu
shine=świecić
snow=padać, o śniegu 
clear up=przejaśniać się
pour down|pour with rain=lać, padać obficie 
branch=gałąź
bush=krzak
crop=uprawa, plon
crown=korona 
flower=kwiat
fruit=owoc
grass=trawa
greenhouse=szklarnia 
harvest=żniwa, zbiór, plon
leaf=liść
leaves=liście
plant=roślina
exotic=roślina egzotyczna
root=korzeń
soil=gleba
species=gatunek
tree=drzewo
trunk=pień
vegetable=warzywo 
grow=rosnąć, uprawiać
harvest=zbierać plony
plant=sadzić
water=podlewać 
cut a tree=wyciąć drzewo
grow plants=hodować rośliny
pick fruit=zbierać owoce 
alligator=aligator
amphibian=płaz
animal=zwierzę
domestic animal=zwierzę domowe
farm animal=zwierzę gospodarskie
animal species=gatunekzwierzęcia
ant=mrówka
badger=borsuk
bat=nietoperz
beak=dziób
bee=pszczoła
honey bee=pszczoła miodna
beetle=chrząszcz
bird=ptak
brown bear=niedźwiedź brunatny
bull=byk
butterfly=motyl
camel=wielbłąd
chimpanzee=szympans
cockroach=karaluch
cow=krowa
crab=krab
crocodile=krokodyl
creature=stworzenie
deer=sarna, jeleń
red deer=jeleń
roe deer=sarna
dolphin=delfin
donkey=osioł
duck=kaczka
elephant=słoń
European bison=żubr
feather=pióro
fish=ryba
flipper=płetwa
fly=mucha
fox=lis
goat=koza
guide dog=pies przewodnik
guinea pig=świnka morska
hamster=chomik
hare=zając 
hen=kura
herring=śledź
horse=koń
insect=owad
kitten=kocię, kociak
lamb=jagnię, owieczka
lizard=jaszczurka
mammal=ssak
monkey=małpa
mosquito=komar
owl=sowa
parrot=papuga
pelikan=pelikan
penguin=pingwin
pig=świnia
pigeon=gołąb
polar bear=niedźwiedź polarny
pony=kucyk
puppy=szczenię, szczeniak
rabbit=królik
rat=szczur
reptile=gad
robin=rudzik
salmon=łosoś
sardine=sardynka
seal=foka
sheep=owca, owce
snake=wąż
species=gatunek
squirrel=wiewiórka
stag=jeleń, samiec
stork=bocian
swan=łabędź
tame=oswojony
termite=termit
mound=kopiec
tortoise=żółw
tuna=tuńczyk
whale=wieloryb
wild boar=dzik
wing=skrzydło
wolf=wilk 
bark=szczekać
bite=gryźć
buzz=brzęczeć
feed=karmić
miaow=miauczeć
roar=ryczeć
scratch=podrapać 
breed animals=hodować zwierzęta
train a dog=tresować psa 
destruction=zniszczenie
drought=susza
earthquake=trzęsienie ziemi
famine=głód
fire=pożar
bush fire=pożar buszu
forest fire=pożar lasu
flood=powódź
hurricane=huragan
natural disaster=klęska żywiołowa
tornado=tornado, trąba powietrzna
tsunami=tsunami
volcanic eruption=wybuch wulkanu
volcano=wulkan 
destroy=zniszczyć
erupt=wybuchnąć
flood=zalać, zatopić
rattle=grzechotać, stukotać
shake=zatrząść się
starve=umierać z głodu 
the river burst its banks=rzeka wystąpiła z brzegów 
acid rain=kwaśny deszcz
aerosol=aerozol
atmosphere=atmosfera
biodegradable=ulegający biodegradacji
car exhaust fumes=spaliny
carbon dioxide=dwutlenek węgla
climate change=zmiana klimatu
coal=węgiel
conservation=ochrona przyrody/środowiska
consumerism=konsumpcjonizm
consumption=konsumpcja
deforestation=wylesianie, deforestacja
disposable=jednorazowego użytku
endangered species=zagrożone gatunki
energy-saving=energooszczędny
environment=środowisko naturalne
environmental=dotyczący środowiska
environmentalist=ekolog
extinct=wymarły,o  gatunku
extinction=wyginięcie, wymarcie
in danger of extinction=zagrożony wyginięciem
fall in temperature=spadek temperatury
global warming=globalne ocieplenie
gravity=grawitacja
greenhouse effect=efekt cieplarniany
habitat=siedlisko gatunku, habitat
heat=gorąco, ciepło
industry=przemysł
landfill/dump=wysypisko śmieci
lead=ołów
litter=śmieci
natural resources=zasoby naturalne
oil spill=wyciek ropy
organic=organiczny, naturalny
overfishing=nadmierny połów ryb
overpopulation=przeludnienie
ozone layer=powłoka ozonowa
hole in the ozone layer=dziura ozonowa
ozone-friendly=bezpieczny dla powłoki ozonowej 
petrol=benzyna
unleaded petrol=benzyna bezołowiowa
polar ice cap=podbiegunowa czapa lodowa
pollution=zanieczyszczenie
air pollution=zanieczyszczenie powietrza
soil pollution=zanieczyszczenie gleby
water pollution=zanieczyszczenie wody
protected species=gatunki chronione
rainforest=las deszczowy, las tropikalny
recycling=ponowne przetwarzanie zużytych produktów, recykling
rise in temperature=wzrost temperatury
smog=smog
steam=para
sustainable=nienaruszający równowagi ekologicznej
sustainable development=zrównoważony rozwój
unsustainable=naruszający równowagę ekologiczną
tidal=pływowy
tide=przypływ, odpływ
ultra-violet radiation=promieniowanie ultrafioletowe
waste=odpadki
wildlife=dzika przyroda 
absorb=wchłaniać
burn=palić, spalać
enable=umożliwiać
generate=wytwarzać
melt=topnieć
pollute=zanieczyszczać
protect=chronić
recycle=ponownie przetwarzać
save=oszczędzać
sustain=podtrzymywać, utrzymywać 
at risk of extinction=zagrożony wymarciem
become extinct=wymierać
burn rubbish=palić śmieci
cut down forests=wycinać lasy
damage the environment=niszczyć środowisko
destroy resources=niszczyć zasoby
environmentally friendly=przyjazny dla środowiska
environmentally friendly products=produkty ekologiczne
generate CO2=wytwarzać dwutlenek węgla
harm the environment=szkodzić środowisku
harmful to the environment=szkodliwy dla środowiska
leave the water=running zostawić odkręcony kran
on the brink of extinction=na granicy wymarcia
pass through the atmosphere=przenikać przez atmosferę
pick/clean up litter=sprzątać śmieci
point sth out=wskazywać coś, zwrócić uwagę na coś 
prevent global warming=zapobiegać globalnemu ociepleniu
protect the environment=chronić środowisko naturalne
protect wildlife=chronić dziką przyrodę
reduce the emissions of greenhouse gases=zmniejszać emisję gazów cieplarnianych
save energy=oszczędzać energię
save water=oszczędzać wodę
sort rubbish=segregować śmieci
throw sth out=wyrzucić coś
turn off the light=wyłączyć światło
waste energy=marnować energię
waste resources=marnować zasoby 
clean electricity=czysta energia elektryczna
energy=energia alternative
alternative energy sources=alternatywne źródła energii
geothermal energy=energia geotermalna
nuclear energy=energia nuklearna
renewable energy=energia odnawialna
source of energy=źródło energii
total energy consumption=całkowite zużycie energii
fuel=paliwo
fossil fuel=paliwo kopalne
hydroelectricity=energia elektryczna z hydroelektrowni
natural gas=gaz ziemny
oil/petroleum=ropa naftowa
power=energia
electric power=eneraa elektryczna
solar power=energia słoneczna
water power=energia wodna
wind power=energia wiatrowa
power plant/station=elektrownia
hydroelectric power plant/station=elektrownia hydroelektryczna
solar battery=bateria słoneczna
wind farm=farma wiatrowa
wind turbine=turbina wiatrowa, wiatrak 
be modelled on sth=być wzorowanym na czymś
burn fuel=spalać paliwo
burn petrol=spalać benzynę
generate/produce energy=wytwarzać energię
reflect light=odbijać światło
store water=magazynować wodę 
comet=kometa
meteor=meteor
planet=planeta
satellite=satelita
universe=wszechświat 

[Unit 14 Państwo i społeczeństwo]
ambassador=ambasador
authorities=władze
bureaucracy=biurokracja
border=granica
border countries=państwa sąsiadujące
cabinet=rząd, gabinet
minister=minister
capital=stolica
citizen=obywatel
citizenship=obywatelstwo
city/town councillor=radny
city/town hall=ratusz
city/town council=rada miejska
civil servant=urzędnik państwowy
conservative=konserwatywny
constitution=konstytucja
democracy=demokracja
democratic=demokratyczny
demonstration=manifestacja
domestic=krajowy
election=wybory
general election=wybory powszechne
localelection=wybory samorządowe
embassy=ambasada
emigration=emigracja
empire=imperium
exile=wygnanie
federal=federalny
foreign=obcy, zagraniczny
foreigner|foreign national=obcokrajowiec
government=rząd
minority government=rząd mniejszościowy
system of government=system polityczny
head of state=głowa państwa
home country|homeland=ojczyzna
House of Commons=Izba Gmin
House of Lords=Izba Lordów
House of Representatives=Izba Reprezentantów
human rights=prawa człowieka
immigrant=imigrant
immigration=imigracja
independence=niepodległość  
inhabitant/resident=mieszkaniec
institution=instytucja
intelligence service=służby wywiadowcze
king=król
kingdom=królestwo
left wing=lewicowy
liberal=liberalny
majority=większość
Mayor=burmistrz
Member of Parliament|MP=poseł
Minister=minister
minority=mniejszość
monarch=monarcha
monarchy=monarchia
constitutional monarchy=monarchia konstytucyjna
nation=naród
national=narodowy, państwowy
national anthem=hymn państwowy
national flag=flaga państwowa
national identity=tożsamość narodowa
nationality=narodowość
opinion poll=badanie opinii publicznej
opposition=opozycja
parliament=parlament
party member=członek partii
policy=polityka, sposób postępowania
social policy=polityka społeczna
political=polityczny
political leader=przywódca polityczny
political scene=scena polityczna
political system=system polityczny
politician=polityk
politics=polityka, działalność publiczna
population=ludność
President=prezydent
Prime Minister|PM=premier
province=prowincja
queen=królowa
reform=reforma
refugee=uchodźca
representative=reprezentant
republic=republika
right wing=prawicowy
royal family=rodzina królewska
secret service=służby specjalne
Senate=senat
Senator=senator 
social democratic=socjaldemokratyczny
socialist=socjalistyczny
socialist=socjalista
state=państwo
term=kadencja
the people=naród, lud
United States Congress=Kongres Stanów Zjednoczonych
demonstrate=manifestować
elect=wybierać
emigrate=emigrować
immigrate=imigrować
represent=reprezentować
rule/govern=rządzić
support=wspierać
adopt the constitution=przyjąć konstytucję
become a citizen=zostać obywatelem
border with=graniczyć z
form a government/cabinet=utworzyć rząd
gain/win independence=uzyskać niepodległość
gain/win support=zdobyć poparcie
hold an election=zorganizować wybory
join a political party=wstąpić do partii politycznej
vote for=głosować na
Your Majesty=Wasza Królewska Mość 
Amnesty International=Amnesty International, organizacja działająca na rzecz praw człowieka
European Union|EU=Unia Europejska
International Monetary Fund|IMF=Międzynarodowy Fundusz Walutowy
non-governmental organisation|NGO=organizacja pozarządowa
North Atlantic Treaty Organisation|NATO=Pakt Północnoatlantycki, NATO
United Nations|UN=Organizacja Narodów Zjednoczonych, ONZ
World Health Organisation|WHO=Światowa Organizacja Zdrowia, WHO 
budget=budżet
coin=moneta
commerce=handel
credit=kredyt
credit card=karta kredytowa
currency=waluta
common currency=wspólna waluta
economics=ekonomia
economy=gospodarka
free-market=gospodarka wolnorynkowa
finance=finanse
financial=finansowy
fund=fundusz
gross domestic product|GDP=produkt krajowy brutto PKB
income=dochód
industry=przemysł
inflation=inflacja
rate of inflation=stopa inflacji
international trade=handel międzynarodowy
investment=inwestycja
market=rynek
black market=czarny rynek
free market=wolny rynek
note=banknot
small business=drobne przedsiębiorstwo
tax=podatek
trade union=związek zawodowy 
invest=inwestować
go down=spadać
grow by four per cent=urosnąć o cztery procent
provide new jobs=tworzyć nowe miejsca pracy
reduce taxes=obniżyć podatki 
civilian=cywil
conflict=konflikt
machine gun=karabin maszynowy
peace conference=konferencja pokojowa
poison gas=gaz trujący
shell-shock=wstrząs psychiczny wywołany przez ostrzał artyleryjski
soldier=żołnierz
tank=czołg
troops=wojsko
weapon=broń
world peace=pokój na świecie
world war=wojna światowa 
invade= najeżdżać
break out=wybuchnąć
declare war on sb=wypowiedzieć komuś wojnę 
aid=pomoc
charity=organizacja charytatywna
corruption=korupcja
disability=niepełnosprawność 
discrimination=dyskryminacja
drug abuse=narkomania
equal=równy
unequal=nierówny
equality=równouprawnienie
government programme=program rządowy
homeless=bezdomny
homelessness=bezdomność
orphanage=sierociniec
poverty=bieda
racism=rasizm
religion=religia
social issues=kwestie społeczne
unemployment=bezrobocie
voluntary work=wolontariat
volunteer=wolontariusz
accept bribes=przyjmować łapówki
discriminate against sb=dyskryminować kogoś
on the dole=na zasiłku dla bezrobotnych
out of work=bez pracy
raise money=zbierać pieniądze 
alibi=alibi
anti-social behaviour=postawa aspołeczna
arson=podpalenie
arsonist=podpalacz
assault=napaść
blackmail=szantaż
blackmailer=szantażysta
burglar=włamywacz
burglary=kradzież z włamaniem
child pornography=pornografia dziecięca
crime=przestępstwo, przestępczość
crime scene=miejsce popełnienia przestępstwa
criminal=przestępca
drug dealer=handlarz narkotyków
drug dealing/trafficking=handel narkotykami
evidence=dowody
fearless=nieustraszony
fingerprint=odcisk palca
fraud=oszustwo
getaway car=samochód używany do ucieczki z miejsca przestępstwa
hacker=haker
hacking=hakerstwo
heartless=okrutny
hoax call=fałszywy telefon
hostage=zakładnik
investigation=śledztwo, dochodzenie
jaywalking=przechodzenie przez ulicę w niedozwolonym miejscu
kidnapper=porywacz
kidnapping=porwanie
littering=zaśmiecanie
mugger=bandyta uliczny
mugging=rozbój 
murder=morderstwo
murderer=morderca
offence=przestępstwo, wykroczenie
pickpocket=kieszonkowiec
pickpocketing=kradzież kieszonkowa
piracy=piractwo
private detective=prywatny detektyw
ransom=okup
rape=gwałt
rapist=gwałciciel
robber=rabuś
robbery=napad rabunkowy
armed robbery=napad rabunkowy z użyciem broni
security camera=kamera nadzorująca
shoplifter=złodziej sklepowy
shoplifting=kradzież sklepowa
smuggler=przemytnik
smuggling=przemyt
speeding=przekroczenie prędkości przez kierowcę
terrorism=terroryzm
theft=kradzież
thief=złodziej
undercover=tajny
vandal=wandal
vandalism=wandalizm
violence=przemoc
weapon=broń
arrest=aresztować
assault=napaść
attack=atakować
attempt=próbować, usiłować
blackmail=szantażować
burgle=włamać się i okraść
capture=schwytać
cheat=oszukiwać
investigate=prowadzić dochodzenie
kidnap=porwać
kill=zabić
mug=napaść na ulicy
murder=zamordować
rape=zgwałcić
rob=obrabować
shoot=strzelać, zastrzelić
shoplift=kraść w sklepie
smuggle=przemycać
steal=kraść
be identified=zostać zidentyfikowanym
blow up=wysadzić w powietrze
break into=włamać się do
break out of prison=uciec z więzienia
break the law=złamać prawo
commit a crime=popełnić przestępstwo
get away with sth=uniknąć kary za coś
have a criminal=record być notowanym
hold up sth=napadać
make off=uciekać
pick sb's pocket=kraść z kieszeni
plant a bomb=podłożyć bombę
set fire to sth=podpalić coś
solve a mystery=rozwiązać zagadkę 
take sb hostage=wziąć kogoś jako zakładnika 
arrest=aresztowanie
ban=zakaz
stadium ban=zakaz stadionowy
community service=prace społeczne
court|court of law=sąd
death penalty|capital punishment=kara śmierci
defence=obrona
defendant=oskarżony
fairness=sprawiedliwość
fine=mandat, grzywna
guilty=winny
imprisonment=kara pozbawienia wolności
life imprisonment=dożywocie
five years imprisonment=pozbawienia wolności
innocent=niewinny
judge=sędzia
jury=ława przysięgłych
justice=sprawiedliwość
law=prawo
lawyer=prawnik
defence lawyer=adwokat obrony
penalty=kara
police officer=policjant
prison/jail=więzienie
prosecution=oskarżenie
prosecutor=prokurator
punishment=kara
sentence=wyrok
prison sentence=kara pozbawienia wolności
suspended sentence=wyrok w zawieszeniu
severe=surowa
suspect=podejrzany
trial=rozprawa, proces
verdict=werdykt
victim=ofiara
witness=świadek
deny=zaprzeczać
punish=karać
testify=zeznawać
accuse sb of sth=oskarżyć kogoś o coś
announce the verdict=ogłosić werdykt
be under arrest=być aresztowanym
drop charges=wycofać oskarżenie
go on trial=stanąć przed sądem
have the right to remain silent=mieć prawo zachować milczenie
in cold blood=z zimną krwią
lock sb up=zamykać kogoś w areszcie/więzieniu
on suspicion of murder=pod zarzutem morderstwa
reach a verdict=uzgodnić werdykt
release from prison=zwolnić z więzienia
sentence to=skazać na
serve a sentence=odsiadywać wyrok
suspect sb of sth=podejrzewać kogoś o coś
Your Honour=Wysoki Sądzie 



