[Focus]

[Unit 1]
able to = zdolny do
adorable = zachwycający, uroczy
ambitious = ambitny
arrogant = arogancki, bezczelny
bad-tempered = wybuchowy
boring = nudny
brave = odważny
bravery = odwaga
caring = troskliwy
cheerful = radosny
clever = mądry, inteligentny
confident = pewny siebie
cooperative = skłonny do współpracy
cowardly = tchórzliwy
crazy = zwariowany
dishonest = nieuczciwy
disloyal = nielojalny
dull = nudny, nieciekawy
emotional = emocjonalny, uczuciowy
energetic = energiczny
enthusiastic = entuzjastyczny
experienced = doświadczony
fair = sprawiedliwy
fit = sprawny
friendly = przyjazny, życzliwy
funny = wesoły, zabawny
generosity = hojność
generous = hojny, wspaniałomyślny
good at = dobry w
grumpy = zrzędliwy, gburowaty
hard-working = pracowity
helpful = uczynny
honest = szczery, uczciwy
inexperienced = niedoświadczony
insensitive = niewrażliwy
interesting = interesujący
irresponsible = nieodpowiedzialny
kind = dobry, życzliwy
laziness = lenistwo
lazy = leniwy
loyal to = lojalny wobec
loyalty = lojalność
mean = skąpy
miserable = ponury, zbolały
modest = skromny
modesty = skromność
negative about = negatywnie nastawiony do
optimistic = optymistyczny
outgoing = otwarty, towarzyski
pessimistic = pesymistyczny
popular = popularny, lubiany
positive = pozytywny
responsibility = odpowiedzialność
responsible for = odpowiedzialny za
selfish = egoistyczny
sensible = rozsądny
sensitive to = wrażliwy na
serious = poważny
shy = nieśmiały
sociable = towarzyski
stupid = głupi
successful = odnosić sukcesy
uncommunicative = niekomunikatywny
uncooperative = niechętny do współpracy
unfair = niesprawiedliwy
unfit = w słabej kondycji
unhelpful = niechętny do pomocy
unkind = niemiły
unpopular = nie cieszyć się sympatią
unsuccessful = nie odnieść sukcesu
bad mood = zły nastrój
crazy about sth = szaleć za czymś
disappointed with sth = rozczarowany czymś
inspired by sth = zainspirowany czymś
interested in sth = zainteresowany czymś
involved in = zaangażowany w
keen on = lubić coś
obsessed with = mieć obsesję na punkcie czegoś
passionate about = pasjonować się czymś
serious about = poważnie podchodzić do czegoś
casual clothes = swobodne ubrania
designer clothes = ubrania od znanych projektantów
hoodie = bluza z kapturem
jacket = kurtka, marynarka
skinny jeans = dżinsy rurki
suit = garnitur
sweatpants = spodnie dresowe
tie = krawat
uniform = mundur
winter coat = kurtka zimowa
adapt to = przystosować się do
admire = podziwiać
argue = kłócić się
avoid sth = unikać czegoś
can't afford sth = nie móc pozwolić sobie na coś
can't stand doing sth = nie znosić robienia czegoś
care about sth = przejmować się czymś
charity = organizacja charytatywna
developing country = kraj rozwijający się
elderly = starszy
experience = doświadczenie
get a job = znaleźć pracę
have sth in common = mieć coś wspólnego
healthy = zdrowy
homeless = bezdomny
housework = prace domowe
human rights = prawa człowieka
identity = tożsamość
impress = robić wrażenie na
inspire = inspirować
make a good impression = zrobić dobre wrażenłe
opportunity = okazja
peace = pokój
priority = priorytet
prison = więzienie
refuse to do sth = odmówić zrobienia czegoś
role model = wzór do naśladowania
spend money on = wydawać pieniądze na
spend time = spędzać czas
stereotype = stereotyp
survey = sondaż
take risks = podejmować ryzyko
team-player = osoba umiejąca pracować w zespole
unhealthy = niezdrowy
voluntary work = wolontariat
volunteer = wolontariusz / wolontariuszka

[Unit 2]
antibiotics = antybiotyki
camera = aparat fotograficzny
communication satellite = satelita komunikacyjny
credit card = karta kredytowa
GPS = GPS
jet engine = silnik odrzutowy
mobile phone = telefon komórkowy
nuclear power = energia jądrowa
radar = radar
refrigerator = lodówka
robot = robot
television = telewizja
washing machine = pralka
attach a photo = załączyć zdjęcie
battery = bateria
blog = blog
broadband = szerokie pasmo połączenia z Internetem
click on an icon = kliknąć na ikonkę
crash = zawiesić się
desktop computer = komputer stacjonarny
digital = cyfrowy
document = dokument
download music = ściągać muzykę
e-book = e-book
e-ink = atrament elektroniczny
electronic = elektroniczny
email = e-mail
follow sb on Twitter = śledzić kogoś na Twitterze
go dead = rozładować się
go online = łączyć się z internetem
hang up = rozłączyć się
icon = ikonka
Internet server = serwer internetowy
keyboard = klawiatura
laptop = laptop
log on = logować się
menu = menu
mouse = mysz
open a document = otworzyć dokument
password = hasło
scanner = skaner
screen = ekran
scroll up|scroll down = przewinąć w górę / w dół
search engine = wyszukiwarka
social networking site = portal społecznościowy
switch on = włączyć
text message = wiadomość tekstowa
tweet = wiadomość na Twitterze
update your profile = aktualizować profil
username = nazwa użytkownika
virus = wirus
visit a website = odwiedzić stronę internetową
analyse = analizować
analysis = analiza
archaeologist = archeolog / archeolożka
archaeology = archeologia
chemicals = chemikalia
chemist = chemik / chemiczka
chemistry = chemia
collect evidence = gromadzić dowody
data = dane
discover = odkryć
discovery = odkrycie
do experiments = robić eksperymenty
do research = prowadzić badania
ecologist = ekolog / ekolożka
ecology = ekologia
engineer = inżynier
environment = środowisko
evolution = ewolucja
evolve = ewoluować
exploration = badanie, odkrywanie
explore = badać, eksplorować
find a cure = znaleźć lekarstwo
geologist = geolog
geology = geologia
global warming = globalne ocieplenie
imagination = wyobraźnia
imagine = wyobrazić sobie
make a discovery = dokonać odkrycia
marine biologist = biolog morski / biolożka morska
marine biology = biologia (morska)
mathematician = matematyk / matematyczka
mathematics = matematyka
nature = przyroda, natura
observation = obserwacja
observe = obserwować
oxygen = tlen
physicist = fizyk / fizyczka
physics = fizyka
preservation = ochrona, konserwacja
preserve = zachować, ochronić
protect = chronić
protection = ochrona
researcher = badacz / badaczka
science = nauki ścisłe
scientist = naukowiec
solution = rozwiązanie
solve = rozwiązać
technology = technika, technologia
astronaut = astronauta / astronautka
astronomy = astronomia
atmosphere = atmosfera
black hole = czarna dziura
capsule = kapsuła
commander = dowódca
explosion = wybuch
fuel tank = zbiornik paliwa
gravity = grawitacja
hatch = okienko
launch = wystrzelenie
mission control = kontrola lotów kosmicznych
moon = księżyc
on board = na pokładzie
orbit = okrążyć
parachute = spadochron
planet = planeta
space = kosmos
spacecraft = statek kosmiczny
splash down = lądować na wodzie
breathe a sigh of relief = odetchnąć z ulgą
carry out = przeprowadzić
cheer = wiwatować
come up with = wymyślić, zaproponować
figure out = zrozumieć
find a solution = znaleźć rozwiązanie
fix a problem = rozwiązać problem
follow events = śledzić wydarzenia
get home = wrócić do domu
go crazy = wariować
on duty = na służbie
raise your hand = podnieść rękę
run out = kończyć się
spend hours = spędzać długie godziny
hatch = okienko / właz

[Unit 3]
abstract = abstrakcyjny
art gallery = galeria sztuki
artist = artysta / artystka
black and white = carno biały
brush = pędzel
colour = kolor
exhibition = wystawa
landscape = pejzaż
museum = muzeum
oil painting = obraz olejny
paint = farba
painter = malarz / malarka
photo|photograph = zdjęcie
photographer = fotograf
photography = fotografia, fotografika
portrait = portret
sculptor = rzeźbiarz / rzeźbiarka
sculpture = rzeźba
street art = sztuka uliczna
street artist = artysta uliczny
studio = pracownia
action film = film akcji
adaptation = adaptacja
adventure film = film przygodowy
autobiography = autobiografia
biography = biografia
classic = klasyka, klasyczny
comedy = komedia
cookbook = książka kucharska
crime story|crime film = kryminał
documentary = film dokumentalny
drama = dramat
encyclopedia = encyklopedia
fairy tale = bajka
fantasy novel|fantasy film = powieść / film fantasy
ghost story = opowieść o duchach
historical drama = dramat historyczny
horror = horror
musical = musical
novel = powieść
play = sztuka
poetry = poezja
romantic comedy = komedia romantyczna
romantic fiction = romans
science fiction novel|science fiction film = powieść / film science fiction
short story = opowiadanie
thriller = thriller
travel guide = przewodnik turystyczny
war film = film wojenny
western = western
act = grać
acting = gra aktorska
animation = animacja
author = autor / autorka
award-winning = nagrodzony
based on = oparty na
best-seller = bestseller
book review|film review = recenzja książki / filmu
camera = kamera
central character = główny bohater / główna bohaterka
chapter = rozdział
costume = kostium
dialogue = dialogi
direct = reżyserować
filming = filmowanie, zdjęcia
give a good performance as = dobrze wykonać rolę
hold your attention = przykuwać uwagę
lead actor = aktor grający główną rolę
literary critic = krytyk literacki
movie = film
novelist = pisarz / pisarka
perform = występować
performance = występ, spektakl, wykonanie
play the role of = grać rolę
playwright = dramatopisarz / dramatopisarka
plot = fabuła
poem = wiersz
poet = poeta / poetka
producer = producent / producentka
scene = scena, fragment utworu
screenplay|script = scenariusz
scriptwriter = scenarzysta / scenarzystka
setting = sceneria
soundtrack = ścieżka dźwiękowa
special effects = efekty specjalne
stage = scena, miejsce występu
storyline = fabuła
suspense = napięcie, niepewność
take place in = rozgrywać się w
tension = napięcie
verse = strofa, zwrotka
violence = przemoc
writer = pisarz / pisarka
X-rated = tylko dla dorosłych
album = płyta
band = zespół
classical music = muzyka klasyczna
composer = kompozytor / kompozytorka
hit = przebój
instrument = instrument
jazz = jazz
live = na żywo
music award = nagroda muzyczna
music festival = festiwal muzyczny
opera = opera
piano = fortepian
singer = piosenkarz / piosenkarka
song = piosenka
songwriter|autor = autorka piosenek
symphony = symfonia
the charts = lista przebojów
track = utwór
vocal range = skala głosu
comedian = komik
episode = odcinek
journalist = dziennikarz / dziennikarka
newspaper article = artykuł z gazety
report = relacja
sitcom = serial komediowy z udziałem publiczności
TV presenter = prezenter / prezenterka TV
description = opis
amazing = zdumiewający
amusing = zabawny
boring = nudny
brilliant = doskonały, kapitalny
emotional = wzbudzający emocje
enjoyable = przyjemny
entertaining = zajmujący
excellent = znakomity
factual = oparty na faktach
funny = śmieszny
great = wspaniały
inspiring = porywający
rnoving = poruszający
perfect = idealny, perfekcyjny
predictable = przewidywalny
relaxing = relaksujący
true-life = z życia wzięty
unoriginal = mało oryginalny
unrealistic = nierealistyczny
wonderful = cudowny

[Unit 4]
bungalow = dom parterowy
cottage = domek wiejski
detached house = dom wolnostojący
eco-house = dom ekologiczny
flat = mieszkanie
houseboat = łódź mieszkalna
semi-detached house = pół domu bliźniaczego
studio apartment = kawalerka
terraced house = dom szeregowy
in a village = w wiosce
in the city centre = w centrum miasta
in the countryside = na wsi
in the suburbs = na przedmieściach
near the sea = blisko morza
on a housing estate = na osiedlu
on the edge of the city = na obrzeżach miasta
brick = cegła
concrete = beton
mud = błoto
stone = kamień
wood = drewno
comfortable = wygodny
cosy = przytulny
lots of natural light = mnóstwo naturalnego światła
modern = nowoczesny
open-plan = bez ścianek działowych
spacious = przestronny
traditional = tradycyjny
basement = piwnica
bedside table = stolik nocny
bookcase = regał na książki
bookshelf = półka na książki
carpet = dywan
ceiling = sufit
central heating = centralne ogrzewanie
cooker = kuchenka
couch = kanapa
cupboard = szafka
duvet = kołdra
electricity = energia elektryczna
floor = odłoga, piętro
floorboard = deska podłogowa
fridge = lodówka
kitchen sink = zlew
lamp = lampa
shelf = półka
single bed = pojedyncze łóżko
sofa = sofa
stairs = schody
toilet = toaleta
wardrobe = szafa na ubrania
windowsill = parapet
wood-burner = piec opalany drewnem
worktop = blat kuchenny
back door = tylne drzwi
balcony = balkon
front door = drzwi frontowe
garage = garaż
path = ścieżka
patio = taras
pond = staw
porch = ganek
roof = dach
shed = szopa, składzik
sky-light = okno dachowe
solar panel = panel słoneczny
stone wall = kamienny mur
beach = plaża
bridge = most
canal = kanał
canyon = kanion
castle = zamek
coast = wybrzeże
harbour = port
hill = wzgórze
island = wyspa
monument = pomnik
mountain = góra
rainforest = las deszczowy
reef = rafa
river = rzeka
rock = skała
ruins = ruiny
slums = slumsy
square = plac
statue = pomnik, rzeźba
temple = świątynia
valley = dolina
a must = konieczność
accommodation = zakwaterowanie
attract tourists = przyciągać turystów
attraction = atrakcja
breathtaking view = widok zapierający dech w piersiach
entertainment = rozrywka
historic site = zabytek, historyczne miejsce
host = gospodarz / gospodyni
local speciality = miejscowa specjalność
nightlife = życie nocne
sights = widoki, miejsca godne zobaczenia
tourist destination = cel wycieczek turystycznych
do the cooking = gotować
do the gardening = pracować w ogrodzie
do the housework = wykonywać prace domowe
do the ironing = prasować
do the shopping = robić zakupy
do the washing = prać
do the washing-up = zmywać
do your best = dawać z siebie wszystko
do your homework = odrabiać pracę domową
make a complaint = złożyć zażalenie
make a decision = podjąć decyzję
make a mess = zrobić bałagan
make a noise = hałasować
make dinner = ugotować obiad
make your bed = pościelić łóżko
architecture = architektura
awesome = niesamowity, wspaniały
busy = ruchliwy, zatłoczony
dominate = dominować
house-warming party = parapetówka
impressive = robiący wrażenie
move house = przeprowadzić się
narrow = wąski
natural wonder = cud natury
neighbour = sąsiad / sąsiadka
neighbourhood = okolica
population = liczba ludności
public transport system = system transportu publicznego
selection = wybór
shallow = płytki
spectacular = widowiskowy, imponujący
teddy bear = pluszowy miś
trading centre = centrum handlu

[Unit 5]
a levels = matura w UK
ability = umiejętność
academic = akademicki
academy = akademia
apply for a place = ubiegać się o miejsce
architecture = architektura
art = sztuka
art history = sztuka historii
attend school = chodzić do szkoły
background = środowisko z którego pochodzisz
be friendly with = przyjaźnić się z
beanbag = poducha do siedzenia
blinds = żaluzje
bully = prześladować
canteen = stołówka
carry on = kontynuować
chill out = zrelaksować się
classmate = koleżanka / kolega z klasy
classroom = sala lekcyjna
collect = zbierać
collection = kolekcja
community = społeczność
to compete against = rywalizować z
compulsory = obowiązkowy
conditions = warunki
decide = zadecydować
decision = decyzja
do a course = uczęszczać na kurs
do a subject = uczyć się przedmiotu
do an exam|take an exam = przystąpić do egzaminu
donate = dać datek
donation = dotacja
drop a subject = rezygnować z nauki przedmiotu
educate = edukować
education = edukacja
primary school|elementary school = szkoła podstawowa
engineering = inżynieria
entrace exam = egzamin wstępny
exhaust = zmęczyć
exhaustion = zmęczenie
explain = wyjaśnić
explanation = wyjaśnienie
to fail an exam = oblać egzamin
field trip = szkolna wycieczka turystyczna
flexible = elastyczny, dający się dopasować
follow one's interests = podążać za swoimi zainteresowaniami
fundraising = zbieranie funduszy
gap year = rok przerwy przed studiami
get a good job = dostać dobrą pracę
get a lot out of sth = odnieść z czegoś dużą korzyść
get a place at university = dostać miejsce na uniwersytecie
get a reply = dostać odpowiedź
get a tattoo = zrobić sobie tatuaż
get better = poczuć się lepiej
get cold = zmarznąć
get dark = ściemniać się
get exhausted = zmęczyć się
get good marks = dostawać dobre oceny
get home = wrócić do domu
get ill = zachorować
get into truble = wpaść w kłopoty
get into university = dostać się na uniwersytet
get late = robi się późno
get nervous = zdenerwować się
get on with = mieć dobre stosunki z
get out of = wyjść z
get ready = przygotować się
get rid of something = pozbyć się czegoś
get stressed about something = stresować się czymś
to get there = dotrzeć na miejsce
to get tired = zmęczyć się
to get to school = dotrzeć do szkoły
get to the station = dotrzeć na stację
get to work = dotrzeć do pracy
get up = wstawać
mark|grade = ocena
to have a good time = dobrze się bawić
invest = inwestować
isolate = izolować
isolation = izolacja
keep a promise = dotrzymać obietnicy
law = prawo
to learn by heart|memorise = uczyć się na pamięć
leave school = przerwać naukę w szkole
literate = umiejący czytać i pisać
meet up with = spotkać się z
to miss lessons = opuszczać lekcje
on one's own = sam
to pass an exam = zdać egzamin
physical education = wychowanie fizyczne
playground = boisko szkolne
provide = zapewnić, dostarczyć
provision = dostarczanie
put on = założyć, włożyć
reach = osiągnąć, dotrzeć na
relax = zrelaksować się
relevant = użyteczny, istotny
remote = odległy
revise = powtarzać materiał
revision = powtórka materiału
rigid = sztywny, ścisły
schedule = harmonogram
school gate = brama szkoły
schoolwork = nauka
science = nauki ścisłe
scrape = zadrapać
secondary school = szkoła średnia
single-sex school = szkoła tylko dla jednej płci
stumble into sth|stumble into something = natknąć się przypadkiem na coś
subject = przedmiot
summit = szczyt
swipe card = karta magnetyczna
take a break = zrobić sobie przerwę
to take it easy = nie przemęczać się
take off = zdjąć
timetable = plan lekcji
tuition fee = czesne
uncluttered = niezagracony, niezaśmiecony
waste of time = strata czasu

[Unit 6]
accountant = księgowy / księgowa
actor = aktor
airline pilot = pilot samolotów pasażerskich
babysitter = opiekun / opiekunka do dziecka
banker = bankowiec
beautician = kosmetyczka
builder = budowlaniec
bus driver = kierowca autobusu
businessman = biznesmen
camp supervisor = wychowawca / wychowawczyni na koloniach
carer = opiekun / opiekunka osób starszych
carpenter = stolarz
computer programmer = programista komputerowy
design consultant = konsultant / konsultantka projektów
DJ = dyskdżokej
doctor = lekarz / lekarka
driving instructor = instruktor / instruktorka jazdy samochodem
electrician = elektryk
engineer = inżynier
estate agent = agent / agentka nieruchomości
flight attendant = steward / stewardesa
hairdresser = fryzjer / fryzjerka
interpreter = tłumacz / tłumaczka
journalist = dziennikarz / dziennikarka
lifeguard = ratownik / ratowniczka
mechanic = mechanik
model = model / modelka
musician = muzyk
nurse = pielęgniarz / pielęgniarka
office assistant = asystent biurowy / asystentka biurowa
photographer = fotograf
plumber = hydraulik
police officer = policjant / policjantka
politician = polityk
receptionist = recepcjonista / recepcjonistka
scientist = naukowiec
secondary school teacher = nauczyciel / nauczycielka szkoły średniej
secretary = sekretarz / sekretarka
shop assistant = sprzedawca / sprzedawczyni
skiing instructor = instruktor / instruktorka jazdy na nartach
specialist = specjalista / specjalistka
taxi driver = taksówkarz
tourist guide = przewodnik / przewodniczka
travel agent = agent turystyczny
apply for a job = ubiegać się o pracę
banking = bankowość
boss = szef / szefowa
candidate = kandydat / kandydatka
career = kariera zawodowa
communication skills = umiejętność komunikowania się
conference call = telefoniczna rozmowa konferencyjna
contact details = dane kontaktowe
CV = CV
employee = pracownik / pracownica
employer = pracodawca
finish work = kończyć pracę
have a job = mieć pracę
holiday job = praca wakacyjna
interwiew = rozmowa kwalifikacyjna
job advert|job advertisement = ogłoszenie o pracy
look for a job = szukać pracy
male-dominated job = zawód zdominowany przez mężczyzn
manual job = praca fizyczna
marketing = marketing
office = biuro
oil industry = przemysł naftowy
part-time job = praca na część etatu
personal skills = indywidualne umiejętności
position = stanowisko
profession = zawód
promotion = awans
retail = sprzedaż detaliczna
retire = przejść na emeryturę
self-confidence = pewność siebie
start work = zaczynać pracę
training = szkolenie
university degree = tytuł naukowy
work experience = doświadczenie zawodowe
work full-time = pracować na pełen etat
be badly paid = źle zarabiać
be in IT|work in IT = działać / pracować w branży komputerowej
be on your feet all day = być cały dzień na nogach
be self-employed = być samozatrudnionym
be weil-paid = dobrze zarabiać
do physical work = wykonywać pracę fizyczną
do flexible hours|work flexible hours = mieć elastyczne godziny pracy
do long hours|work long hours = pracować do późna
do overtime|work overtime = pracować w nadgodzinach
do regular office hours|work regular office hours = pracować w stałych godzinach
do shifts|work shifts = pracować w systemie zmianowym
get a bonus = dostać premię
get a high salary|earn a high salary|get an average salary|earn an average salary = otrzymywać / zarabiać wysoką / średnią pensję
get low wages|earn low wages = otrzymywać niską płacę
get a pay rise|have a pay rise = dostać podwyżkę
get a day off|take a day off|have a day off|take a day off = dostać / mieć / wziąć dzień wolny
get five weeks paid holiday|take five weeks paid holiday|have five weeks paid holiday|take five weeks paid holiday = dostać / mieć / wziąć pięć tygodni płatnego urlopu
take time off = wziąć wolne
work for|work at = pracować w
work for a construction company = pracować w firmie budowlanej
work from home = pracować w domu
work in a hospital|work in a advertising = pracować w szpitalu / branży reklamowej
work in part of a team|work as part of a team = pracować w zespole
work outside = pracować na zewnątrz
work with your hands = pracować fizycznie
be a fast learner = szybko się uczyć
be dependent on = być zależnym od
benefit = korzyść
deal with sth = zajmować się czymś
driving licence = prawo jazdy
enclose = załączyć
find out = sprawdzić, dowiedzieć się
foreign = zagraniczny
give up = porzucić, zrezygnować z
grow = rosnąć, uprawiać
have a shave = ogolić się
native = ojczysty
set up = założyć
shelter = schronienie
sum up = podsumować
throw out = wyrzucić
waste = marnować
work sth out = dojść do czegoś

[Unit 7]
baker's = piekarnia
bookstore = księgarnia
butcher's = rzeźnik, sklep mięsny
charity shop = sklep z używanymi rzeczami prowadzony przez organizację charytatywną
clothes shop = sklep odzieżowy
designer shop = sklep z rzeczami od znanych projektantów
greengrocer's = warzywniak
jeweller's = jubiler
newsagent's = kiosk z gazetami
pet shop = sklep zoologiczny
shoe shop = sklep obuwniczy
shopping centre = centrum handlowe
store = sklep
supermarket = supermarket
toy shop = sklep z zabawkami
aquarium = akwarium
cinema = kino
manicure = manicure
museum = muzeum
post office = poczta
theatre = teatr
theme park = park rozrywki
the dentist = gabinet dentystyczny
the doctor = gabinet lekarski
wedding chapel = kapliczka ślubna
beauty products = kosmetyki
boots = buty z cholewką
carpet = dywan
electrical goods = urządzenia elektryczne
face cream = krem do twarzy
friendship bracelet = bransoletka przyjaźni
game console = konsola do gier
headphones = słuchawki
leisurewear = strój sportowy
light bulb = żarówka
plant = roślina
purse = portmonetka
sandals = sandały
swimwear = stroje kąpielowe
toiletries = przybory toaletowe
trainers = buty sportowe
vacuum cleaner = odkurzacz
advertising = reklama
branding = tworzenie marki
broken = zepsuty
buy on impulse = kupować pod wpływem impulsu
changing room = przymierzalnia
complain = reklamować, składać zażalenie
complaint = zażalenie, reklamacja
consumer = konsument
damaged = uszkodzony
delivery = dostawa
economical = oszczędny
fashionable = modny
faulty = wadliwy
fit = pasować
out of stock = wyprzedany
package = pakować
packaging = opakowanie
product = produkt
quality = jakość
reduced = przeceniony
replacement = towar na wymianę
sell-by date = termin ważności
sell out = sprzedać się
service = obsługa
size = rozmiar
suit = pasować
try on = przymierzyć
value = wartość
attract attention = przyciągać uwagę
close an account = zamknąć konto
do some research = zrobić rozeznanie
do the shopping = robić zakupy
exchange sth for sth = wymienić coś na coś
get a refund = dostać zwrot pieniędzy
go shopping = pójść na zakupy
go window shopping = oglądać wystawy sklepowe
have a sale = urządzać wyprzedaż
I can't afford it = nie stać mnie na to
keep the receipt = zachować paragon
on special offer = w ofercie specjalnej
pay attention to = zwracać uwagę na
pick up a bargain = złowić okazję
shop online = robić zakupy w internecie
some parts are missing = brakuje niektórych części
trust sb with sth = powierzyć coś komuś
a bottle of perfume = flakonik perfum
a bottle of shampoo|a bottle of mineral water = butelka szamponu / wody mineralnej
a bunch of flowers = bukiet kwiatów
a bunch of grapes|a bunch of bananas = kiść winogron / bananów
a can of beans|a can of tomatoes|a can of cola = puszka fasoli / coli / pomidorów
a jar of jam|a jar of instant coffee|a jar of mayonnaise = słoik dżemu / kawy rozpuszczalnej / majonezu
a packet of biscuits|a packet of crisps|a packet of tea = paczka herbatników / herbaty / czipsów
a pair of jeans|a pair of scissors|a pair of skis = para dżinsów / nart / nożyczek
anger = złość
angry = zły
creation = tworzenie, dzieło
creative = twórczy
elegance = elegancja
elegant = elegancki
excitement = podekscytowanie
greed = chciwość
greedy = chciwy
honest = uczciwy
honesty = uczciwość
jealous = zazdrosny
jealousy = zazdrość
Ioyal = lojalny
loyalty = lojalność
mysterious = tajemniczy
mystery = tajemnica
passion = pasja, namiętność
passionate = pełen pasji
competitive = konkurencyjny
focus on = skupić się
make a living = zarobić na życie, utrzymać się
market = rynek
old-fashioned = staromodny
protect the environment = chronić środowisko
reduce poverty = zmniejszać ubóstwo
secure = bezpieczny
security = bezpieczeństwo
trade = handel
wealthy = bogaty
wealth = bogactwo

[Unit 8]
African American = Afroamerykanin
black community = czarna społeczność
Board of Education = wydział edukacji
capital city = stolica
citizen = obywatel / obywatelka
Civil Rights Movement = ruch na rzecz praw obywatelskich
constitutional monarchy = monarchia konstytucyjna
corruption = korupcja
declare = oznajmić
democracy = demokracja
discriminate = dyskryminować
discrimination = dyskryminacja
equal = równy
fight for = walczyć o
freedom = wolność
general elections = wybory powszechne
head of government = szef rządu
head of state = głowa państwa
human race = rasa ludzka
humiliate = poniżać
humiliation = poniżenie
make a speech = wygłosić mowę
Nobel Peace Prize = Pokojowa Nagroda Nobla
political system = system polityczny
Prime Minister = premier
racial discrimination = dyskryminacja na tle rasowym
racial segregation = segregacja rasowa
racism = rasizm
run a campaign = poprowadzić kampanię
segregate = segregować
segregation = segregacja
separate = oddzielać
separation = oddzielenie
sexism = seksizm
slave = niewolnik / niewolnica
slave trade = handel niewolnikami
slavery = niewolnictwo
statistics = statystyka
the Supreme Court = Sąd Najwyższy
tax = podatek
terrorisrn = terroryzm
unemployment = bezrobocie
vote = głosować
arson = podpalenie
assassinate = dokonać zamachu na
assassination = zamach
break into = włamać się do
break the law = złamać prawo
burglary = kradzież z włamaniem
burgle = włamać się i okraść
car crime = przestępstwa związane z samochodami
commit a crime = popełnić przestępstwo
crime scene = miejsce przestępstwa
cyberbullying = cyberprzemoc
damage public property = uszkodzić własność publiczną
deal drugs = handlować narkotykami
drug dealing = handel narkotykami
gang = gang
graffiti = graffiti
hacking = włamanie do sieci komputerowej
illegal = nielegalny
mug = dokonać rozboju
mugging = rozbój
murder = zamordować, morderstwo
murder rates = liczba morderstw
mystery = tajemniczy
online piracy = piractwo internetowe
pirate = nielegalnie kopiować
rob = obrabować
robbery = rabunek
set fire to = podpalić
shoplift = kraść w sklepie
shoplifting = kradzież sklepowa
steal = ukraść
theft = kradzież
vandalise = dewastować
vandalism = wandalizm
victim = ofiara
arsonist = podpalacz
burglar = włamywacz
drug dealer = handlarz narkotykami
mugger = sprawca rozboju
murderer = morderca
pickpocket = kieszonkowiec
pirate = pirat
robber = rabuś
shoplifter = złodziej sklepowy
thief = złodziej
vandal = wandal
appear in court = zeznawać w sądzie
arrest = aresztować
case = sprawa sądowa
catch = złapać
collect evidence = gromadzić materiał dowodowy
community service = prace społeczne
court = sąd
guilty = inny
identity = tożsamość
innocent = niewinny
interview victims|interview witnesses = przesłuchać ofiary / świadków
judge = sędzia
police officer = policjant / policjantka
prison = więzienie
punish = ukarać
report a crime = zgłosić przestępstwo
search = przeszukać
sentence = skazać, wyrok
suspect = podejrzany
witness = świadek
bite your nails = obgryzać paznokcie
blink your eyes = mrugać oczami
cross your arms = skrzyżować ramiona
fiddle with your hair = bawić się włosami
liar = kłamca
lie = kłamać, kłamstwo
raise your eyebrows = unieść brwi
stare at = wpatrywać się w
tell a lie = skłamać
tell the truth = powiedzieć prawdę
boring = nudny
convincing = przekonujący
effective = skuteczny
fake = fałszywy, sfałszowany
false = fałszywy, nieprawdziwy
fascinating = fascynujący
genuine = prawdziwy, oryginalny
life savings = oszczędności całego życia
shocking = szokujący
true = prawdziwy
